"filename", "language", "Python", "Shell Script", "YAML", "comment", "blank", "total"
"/home/wzliu/PCNL_XuanCe/XuanPolicy_Library/xuanpolicy/xuanpolicy/__init__.py", "Python", 4, 0, 0, 0, 1, 5
"/home/wzliu/PCNL_XuanCe/XuanPolicy_Library/xuanpolicy/xuanpolicy/common/__init__.py", "Python", 5, 0, 0, 0, 1, 6
"/home/wzliu/PCNL_XuanCe/XuanPolicy_Library/xuanpolicy/xuanpolicy/common/common_tools.py", "Python", 151, 0, 0, 18, 29, 198
"/home/wzliu/PCNL_XuanCe/XuanPolicy_Library/xuanpolicy/xuanpolicy/common/memory_tools.py", "Python", 397, 0, 0, 91, 70, 558
"/home/wzliu/PCNL_XuanCe/XuanPolicy_Library/xuanpolicy/xuanpolicy/common/memory_tools_marl.py", "Python", 377, 0, 0, 106, 61, 544
"/home/wzliu/PCNL_XuanCe/XuanPolicy_Library/xuanpolicy/xuanpolicy/common/segtree_tool.py", "Python", 69, 0, 0, 3, 15, 87
"/home/wzliu/PCNL_XuanCe/XuanPolicy_Library/xuanpolicy/xuanpolicy/common/statistic_tools.py", "Python", 115, 0, 0, 0, 13, 128
"/home/wzliu/PCNL_XuanCe/XuanPolicy_Library/xuanpolicy/xuanpolicy/configs/__init__.py", "Python", 0, 0, 0, 0, 1, 1
"/home/wzliu/PCNL_XuanCe/XuanPolicy_Library/xuanpolicy/xuanpolicy/configs/a2c/atari.yaml", "YAML", 0, 0, 41, 1, 6, 48
"/home/wzliu/PCNL_XuanCe/XuanPolicy_Library/xuanpolicy/xuanpolicy/configs/a2c/box2d/BipedalWalker-v3.yaml", "YAML", 0, 0, 32, 0, 6, 38
"/home/wzliu/PCNL_XuanCe/XuanPolicy_Library/xuanpolicy/xuanpolicy/configs/a2c/box2d/LunarLander-v2.yaml", "YAML", 0, 0, 32, 0, 6, 38
"/home/wzliu/PCNL_XuanCe/XuanPolicy_Library/xuanpolicy/xuanpolicy/configs/a2c/classic_control/Acrobot-v1.yaml", "YAML", 0, 0, 33, 0, 6, 39
"/home/wzliu/PCNL_XuanCe/XuanPolicy_Library/xuanpolicy/xuanpolicy/configs/a2c/classic_control/CartPole-v1.yaml", "YAML", 0, 0, 33, 0, 6, 39
"/home/wzliu/PCNL_XuanCe/XuanPolicy_Library/xuanpolicy/xuanpolicy/configs/a2c/classic_control/MountainCar-v0.yaml", "YAML", 0, 0, 33, 0, 6, 39
"/home/wzliu/PCNL_XuanCe/XuanPolicy_Library/xuanpolicy/xuanpolicy/configs/a2c/classic_control/Pendulum-v1.yaml", "YAML", 0, 0, 33, 0, 6, 39
"/home/wzliu/PCNL_XuanCe/XuanPolicy_Library/xuanpolicy/xuanpolicy/configs/a2c/mujoco.yaml", "YAML", 0, 0, 33, 0, 6, 39
"/home/wzliu/PCNL_XuanCe/XuanPolicy_Library/xuanpolicy/xuanpolicy/configs/basic.yaml", "YAML", 0, 0, 13, 3, 6, 22
"/home/wzliu/PCNL_XuanCe/XuanPolicy_Library/xuanpolicy/xuanpolicy/configs/c51/atari.yaml", "YAML", 0, 0, 41, 1, 7, 49
"/home/wzliu/PCNL_XuanCe/XuanPolicy_Library/xuanpolicy/xuanpolicy/configs/c51/box2d/CarRacing-v2.yaml", "YAML", 0, 0, 35, 1, 7, 43
"/home/wzliu/PCNL_XuanCe/XuanPolicy_Library/xuanpolicy/xuanpolicy/configs/c51/box2d/LunarLander-v2.yaml", "YAML", 0, 0, 33, 0, 6, 39
"/home/wzliu/PCNL_XuanCe/XuanPolicy_Library/xuanpolicy/xuanpolicy/configs/c51/classic_control/Acrobot-v1.yaml", "YAML", 0, 0, 33, 0, 6, 39
"/home/wzliu/PCNL_XuanCe/XuanPolicy_Library/xuanpolicy/xuanpolicy/configs/c51/classic_control/CartPole-v1.yaml", "YAML", 0, 0, 33, 0, 6, 39
"/home/wzliu/PCNL_XuanCe/XuanPolicy_Library/xuanpolicy/xuanpolicy/configs/c51/classic_control/MountainCar-v0.yaml", "YAML", 0, 0, 33, 0, 6, 39
"/home/wzliu/PCNL_XuanCe/XuanPolicy_Library/xuanpolicy/xuanpolicy/configs/coma/mpe/simple_spread_v3.yaml", "YAML", 0, 0, 38, 0, 7, 45
"/home/wzliu/PCNL_XuanCe/XuanPolicy_Library/xuanpolicy/xuanpolicy/configs/dcg/mpe/simple_spread_v3.yaml", "YAML", 0, 0, 44, 0, 8, 52
"/home/wzliu/PCNL_XuanCe/XuanPolicy_Library/xuanpolicy/xuanpolicy/configs/dcg/sc2/25m.yaml", "YAML", 0, 0, 49, 1, 8, 58
"/home/wzliu/PCNL_XuanCe/XuanPolicy_Library/xuanpolicy/xuanpolicy/configs/dcg/sc2/2m_vs_1z.yaml", "YAML", 0, 0, 49, 1, 8, 58
"/home/wzliu/PCNL_XuanCe/XuanPolicy_Library/xuanpolicy/xuanpolicy/configs/dcg/sc2/3m.yaml", "YAML", 0, 0, 49, 1, 8, 58
"/home/wzliu/PCNL_XuanCe/XuanPolicy_Library/xuanpolicy/xuanpolicy/configs/dcg/sc2/5m_vs_6m.yaml", "YAML", 0, 0, 49, 1, 8, 58
"/home/wzliu/PCNL_XuanCe/XuanPolicy_Library/xuanpolicy/xuanpolicy/configs/dcg/sc2/8m.yaml", "YAML", 0, 0, 49, 1, 8, 58
"/home/wzliu/PCNL_XuanCe/XuanPolicy_Library/xuanpolicy/xuanpolicy/configs/dcg/sc2/8m_vs_9m.yaml", "YAML", 0, 0, 49, 1, 8, 58
"/home/wzliu/PCNL_XuanCe/XuanPolicy_Library/xuanpolicy/xuanpolicy/configs/dcg/sc2/MMM2.yaml", "YAML", 0, 0, 49, 1, 8, 58
"/home/wzliu/PCNL_XuanCe/XuanPolicy_Library/xuanpolicy/xuanpolicy/configs/dcg/sc2/corridor.yaml", "YAML", 0, 0, 49, 1, 8, 58
"/home/wzliu/PCNL_XuanCe/XuanPolicy_Library/xuanpolicy/xuanpolicy/configs/ddpg/box2d/BipedalWalker-v3.yaml", "YAML", 0, 0, 31, 0, 5, 36
"/home/wzliu/PCNL_XuanCe/XuanPolicy_Library/xuanpolicy/xuanpolicy/configs/ddpg/classic_control/Pendulum-v1.yaml", "YAML", 0, 0, 31, 0, 5, 36
"/home/wzliu/PCNL_XuanCe/XuanPolicy_Library/xuanpolicy/xuanpolicy/configs/ddpg/mujoco.yaml", "YAML", 0, 0, 31, 0, 6, 37
"/home/wzliu/PCNL_XuanCe/XuanPolicy_Library/xuanpolicy/xuanpolicy/configs/ddqn/atari.yaml", "YAML", 0, 0, 38, 1, 7, 46
"/home/wzliu/PCNL_XuanCe/XuanPolicy_Library/xuanpolicy/xuanpolicy/configs/ddqn/box2d/CarRacing-v2.yaml", "YAML", 0, 0, 32, 1, 7, 40
"/home/wzliu/PCNL_XuanCe/XuanPolicy_Library/xuanpolicy/xuanpolicy/configs/ddqn/box2d/LunarLander-v2.yaml", "YAML", 0, 0, 30, 0, 6, 36
"/home/wzliu/PCNL_XuanCe/XuanPolicy_Library/xuanpolicy/xuanpolicy/configs/ddqn/classic_control/Acrobot-v1.yaml", "YAML", 0, 0, 30, 0, 7, 37
"/home/wzliu/PCNL_XuanCe/XuanPolicy_Library/xuanpolicy/xuanpolicy/configs/ddqn/classic_control/CartPole-v1.yaml", "YAML", 0, 0, 30, 0, 7, 37
"/home/wzliu/PCNL_XuanCe/XuanPolicy_Library/xuanpolicy/xuanpolicy/configs/ddqn/classic_control/MountainCar-v0.yaml", "YAML", 0, 0, 30, 0, 7, 37
"/home/wzliu/PCNL_XuanCe/XuanPolicy_Library/xuanpolicy/xuanpolicy/configs/dqn/atari.yaml", "YAML", 0, 0, 38, 1, 7, 46
"/home/wzliu/PCNL_XuanCe/XuanPolicy_Library/xuanpolicy/xuanpolicy/configs/dqn/box2d/CarRacing-v2.yaml", "YAML", 0, 0, 32, 1, 7, 40
"/home/wzliu/PCNL_XuanCe/XuanPolicy_Library/xuanpolicy/xuanpolicy/configs/dqn/box2d/LunarLander-v2.yaml", "YAML", 0, 0, 30, 0, 6, 36
"/home/wzliu/PCNL_XuanCe/XuanPolicy_Library/xuanpolicy/xuanpolicy/configs/dqn/classic_control/Acrobot-v1.yaml", "YAML", 0, 0, 30, 0, 6, 36
"/home/wzliu/PCNL_XuanCe/XuanPolicy_Library/xuanpolicy/xuanpolicy/configs/dqn/classic_control/CartPole-v1.yaml", "YAML", 0, 0, 30, 0, 6, 36
"/home/wzliu/PCNL_XuanCe/XuanPolicy_Library/xuanpolicy/xuanpolicy/configs/dqn/classic_control/MountainCar-v0.yaml", "YAML", 0, 0, 29, 0, 6, 35
"/home/wzliu/PCNL_XuanCe/XuanPolicy_Library/xuanpolicy/xuanpolicy/configs/drqn/atari.yaml", "YAML", 0, 0, 42, 1, 7, 50
"/home/wzliu/PCNL_XuanCe/XuanPolicy_Library/xuanpolicy/xuanpolicy/configs/drqn/box2d/CarRacing-v2.yaml", "YAML", 0, 0, 36, 1, 7, 44
"/home/wzliu/PCNL_XuanCe/XuanPolicy_Library/xuanpolicy/xuanpolicy/configs/drqn/box2d/LunarLander-v2.yaml", "YAML", 0, 0, 34, 0, 6, 40
"/home/wzliu/PCNL_XuanCe/XuanPolicy_Library/xuanpolicy/xuanpolicy/configs/drqn/classic_control/Acrobot-v1.yaml", "YAML", 0, 0, 34, 0, 6, 40
"/home/wzliu/PCNL_XuanCe/XuanPolicy_Library/xuanpolicy/xuanpolicy/configs/drqn/classic_control/CartPole-v1.yaml", "YAML", 0, 0, 34, 0, 6, 40
"/home/wzliu/PCNL_XuanCe/XuanPolicy_Library/xuanpolicy/xuanpolicy/configs/drqn/classic_control/MountainCar-v0.yaml", "YAML", 0, 0, 33, 0, 6, 39
"/home/wzliu/PCNL_XuanCe/XuanPolicy_Library/xuanpolicy/xuanpolicy/configs/dueldqn/atari.yaml", "YAML", 0, 0, 38, 1, 7, 46
"/home/wzliu/PCNL_XuanCe/XuanPolicy_Library/xuanpolicy/xuanpolicy/configs/dueldqn/box2d/CarRacing-v2.yaml", "YAML", 0, 0, 32, 1, 7, 40
"/home/wzliu/PCNL_XuanCe/XuanPolicy_Library/xuanpolicy/xuanpolicy/configs/dueldqn/box2d/LunarLander-v2.yaml", "YAML", 0, 0, 30, 0, 6, 36
"/home/wzliu/PCNL_XuanCe/XuanPolicy_Library/xuanpolicy/xuanpolicy/configs/dueldqn/classic_control/Acrobot-v1.yaml", "YAML", 0, 0, 30, 0, 6, 36
"/home/wzliu/PCNL_XuanCe/XuanPolicy_Library/xuanpolicy/xuanpolicy/configs/dueldqn/classic_control/CartPole-v1.yaml", "YAML", 0, 0, 30, 0, 6, 36
"/home/wzliu/PCNL_XuanCe/XuanPolicy_Library/xuanpolicy/xuanpolicy/configs/dueldqn/classic_control/MountainCar-v0.yaml", "YAML", 0, 0, 30, 0, 6, 36
"/home/wzliu/PCNL_XuanCe/XuanPolicy_Library/xuanpolicy/xuanpolicy/configs/iddpg/mpe/simple_adversary_v3.yaml", "YAML", 0, 0, 27, 0, 7, 34
"/home/wzliu/PCNL_XuanCe/XuanPolicy_Library/xuanpolicy/xuanpolicy/configs/iddpg/mpe/simple_push_v3.yaml", "YAML", 0, 0, 25, 0, 7, 32
"/home/wzliu/PCNL_XuanCe/XuanPolicy_Library/xuanpolicy/xuanpolicy/configs/iddpg/mpe/simple_spread_v3.yaml", "YAML", 0, 0, 25, 0, 7, 32
"/home/wzliu/PCNL_XuanCe/XuanPolicy_Library/xuanpolicy/xuanpolicy/configs/ippo/mpe/simple_spread_v3.yaml", "YAML", 0, 0, 44, 1, 7, 52
"/home/wzliu/PCNL_XuanCe/XuanPolicy_Library/xuanpolicy/xuanpolicy/configs/ippo/sc2/2m_vs_1z.yaml", "YAML", 0, 0, 55, 2, 8, 65
"/home/wzliu/PCNL_XuanCe/XuanPolicy_Library/xuanpolicy/xuanpolicy/configs/ippo/sc2/3m.yaml", "YAML", 0, 0, 55, 2, 8, 65
"/home/wzliu/PCNL_XuanCe/XuanPolicy_Library/xuanpolicy/xuanpolicy/configs/iql/football/3v1.yaml", "YAML", 0, 0, 49, 2, 7, 58
"/home/wzliu/PCNL_XuanCe/XuanPolicy_Library/xuanpolicy/xuanpolicy/configs/iql/mpe/simple_spread_v3.yaml", "YAML", 0, 0, 35, 0, 6, 41
"/home/wzliu/PCNL_XuanCe/XuanPolicy_Library/xuanpolicy/xuanpolicy/configs/iql/sc2/25m.yaml", "YAML", 0, 0, 40, 1, 7, 48
"/home/wzliu/PCNL_XuanCe/XuanPolicy_Library/xuanpolicy/xuanpolicy/configs/iql/sc2/2m_vs_1z.yaml", "YAML", 0, 0, 41, 1, 7, 49
"/home/wzliu/PCNL_XuanCe/XuanPolicy_Library/xuanpolicy/xuanpolicy/configs/iql/sc2/3m.yaml", "YAML", 0, 0, 40, 1, 7, 48
"/home/wzliu/PCNL_XuanCe/XuanPolicy_Library/xuanpolicy/xuanpolicy/configs/iql/sc2/5m_vs_6m.yaml", "YAML", 0, 0, 40, 1, 7, 48
"/home/wzliu/PCNL_XuanCe/XuanPolicy_Library/xuanpolicy/xuanpolicy/configs/iql/sc2/8m.yaml", "YAML", 0, 0, 40, 1, 7, 48
"/home/wzliu/PCNL_XuanCe/XuanPolicy_Library/xuanpolicy/xuanpolicy/configs/iql/sc2/8m_vs_9m.yaml", "YAML", 0, 0, 40, 1, 7, 48
"/home/wzliu/PCNL_XuanCe/XuanPolicy_Library/xuanpolicy/xuanpolicy/configs/iql/sc2/MMM2.yaml", "YAML", 0, 0, 40, 1, 7, 48
"/home/wzliu/PCNL_XuanCe/XuanPolicy_Library/xuanpolicy/xuanpolicy/configs/iql/sc2/corridor.yaml", "YAML", 0, 0, 40, 1, 7, 48
"/home/wzliu/PCNL_XuanCe/XuanPolicy_Library/xuanpolicy/xuanpolicy/configs/isac/mpe/simple_adversary_v3.yaml", "YAML", 0, 0, 26, 0, 8, 34
"/home/wzliu/PCNL_XuanCe/XuanPolicy_Library/xuanpolicy/xuanpolicy/configs/isac/mpe/simple_push_v3.yaml", "YAML", 0, 0, 26, 0, 8, 34
"/home/wzliu/PCNL_XuanCe/XuanPolicy_Library/xuanpolicy/xuanpolicy/configs/isac/mpe/simple_spread_v3.yaml", "YAML", 0, 0, 26, 0, 8, 34
"/home/wzliu/PCNL_XuanCe/XuanPolicy_Library/xuanpolicy/xuanpolicy/configs/maddpg/mpe/simple_adversary_v3.yaml", "YAML", 0, 0, 35, 0, 5, 40
"/home/wzliu/PCNL_XuanCe/XuanPolicy_Library/xuanpolicy/xuanpolicy/configs/maddpg/mpe/simple_push_v3.yaml", "YAML", 0, 0, 27, 0, 7, 34
"/home/wzliu/PCNL_XuanCe/XuanPolicy_Library/xuanpolicy/xuanpolicy/configs/maddpg/mpe/simple_spread_v3.yaml", "YAML", 0, 0, 35, 0, 6, 41
"/home/wzliu/PCNL_XuanCe/XuanPolicy_Library/xuanpolicy/xuanpolicy/configs/mappo/mpe/simple_spread_v3.yaml", "YAML", 0, 0, 45, 1, 7, 53
"/home/wzliu/PCNL_XuanCe/XuanPolicy_Library/xuanpolicy/xuanpolicy/configs/mappo/sc2/25m.yaml", "YAML", 0, 0, 55, 2, 8, 65
"/home/wzliu/PCNL_XuanCe/XuanPolicy_Library/xuanpolicy/xuanpolicy/configs/mappo/sc2/2m_vs_1z.yaml", "YAML", 0, 0, 56, 2, 8, 66
"/home/wzliu/PCNL_XuanCe/XuanPolicy_Library/xuanpolicy/xuanpolicy/configs/mappo/sc2/3m.yaml", "YAML", 0, 0, 55, 2, 8, 65
"/home/wzliu/PCNL_XuanCe/XuanPolicy_Library/xuanpolicy/xuanpolicy/configs/mappo/sc2/5m_vs_6m.yaml", "YAML", 0, 0, 55, 2, 8, 65
"/home/wzliu/PCNL_XuanCe/XuanPolicy_Library/xuanpolicy/xuanpolicy/configs/mappo/sc2/8m.yaml", "YAML", 0, 0, 55, 2, 8, 65
"/home/wzliu/PCNL_XuanCe/XuanPolicy_Library/xuanpolicy/xuanpolicy/configs/mappo/sc2/8m_vs_9m.yaml", "YAML", 0, 0, 55, 2, 8, 65
"/home/wzliu/PCNL_XuanCe/XuanPolicy_Library/xuanpolicy/xuanpolicy/configs/mappo/sc2/MMM2.yaml", "YAML", 0, 0, 55, 2, 8, 65
"/home/wzliu/PCNL_XuanCe/XuanPolicy_Library/xuanpolicy/xuanpolicy/configs/mappo/sc2/corridor.yaml", "YAML", 0, 0, 55, 2, 8, 65
"/home/wzliu/PCNL_XuanCe/XuanPolicy_Library/xuanpolicy/xuanpolicy/configs/masac/mpe/simple_push_v3.yaml", "YAML", 0, 0, 26, 0, 8, 34
"/home/wzliu/PCNL_XuanCe/XuanPolicy_Library/xuanpolicy/xuanpolicy/configs/masac/mpe/simple_spread_v3.yaml", "YAML", 0, 0, 26, 0, 8, 34
"/home/wzliu/PCNL_XuanCe/XuanPolicy_Library/xuanpolicy/xuanpolicy/configs/matd3/mpe/simple_push_v3.yaml", "YAML", 0, 0, 25, 0, 7, 32
"/home/wzliu/PCNL_XuanCe/XuanPolicy_Library/xuanpolicy/xuanpolicy/configs/matd3/mpe/simple_spread_v3.yaml", "YAML", 0, 0, 25, 0, 7, 32
"/home/wzliu/PCNL_XuanCe/XuanPolicy_Library/xuanpolicy/xuanpolicy/configs/mfac/mpe/simple_spread_v3.yaml", "YAML", 0, 0, 32, 1, 7, 40
"/home/wzliu/PCNL_XuanCe/XuanPolicy_Library/xuanpolicy/xuanpolicy/configs/mfq/magent2/adversarial_pursuit_v4.yaml", "YAML", 0, 0, 43, 1, 6, 50
"/home/wzliu/PCNL_XuanCe/XuanPolicy_Library/xuanpolicy/xuanpolicy/configs/mfq/mpe/simple_spread_v3.yaml", "YAML", 0, 0, 25, 0, 6, 31
"/home/wzliu/PCNL_XuanCe/XuanPolicy_Library/xuanpolicy/xuanpolicy/configs/mpdqn/Platform.yaml", "YAML", 0, 0, 25, 0, 7, 32
"/home/wzliu/PCNL_XuanCe/XuanPolicy_Library/xuanpolicy/xuanpolicy/configs/noisydqn/atari.yaml", "YAML", 0, 0, 38, 1, 7, 46
"/home/wzliu/PCNL_XuanCe/XuanPolicy_Library/xuanpolicy/xuanpolicy/configs/noisydqn/box2d/CarRacing-v2.yaml", "YAML", 0, 0, 32, 1, 7, 40
"/home/wzliu/PCNL_XuanCe/XuanPolicy_Library/xuanpolicy/xuanpolicy/configs/noisydqn/box2d/LunarLander-v2.yaml", "YAML", 0, 0, 30, 0, 6, 36
"/home/wzliu/PCNL_XuanCe/XuanPolicy_Library/xuanpolicy/xuanpolicy/configs/noisydqn/classic_control/Acrobot-v1.yaml", "YAML", 0, 0, 30, 0, 6, 36
"/home/wzliu/PCNL_XuanCe/XuanPolicy_Library/xuanpolicy/xuanpolicy/configs/noisydqn/classic_control/CartPole-v1.yaml", "YAML", 0, 0, 30, 0, 6, 36
"/home/wzliu/PCNL_XuanCe/XuanPolicy_Library/xuanpolicy/xuanpolicy/configs/noisydqn/classic_control/MountainCar-v0.yaml", "YAML", 0, 0, 30, 0, 6, 36
"/home/wzliu/PCNL_XuanCe/XuanPolicy_Library/xuanpolicy/xuanpolicy/configs/pdqn/Platform.yaml", "YAML", 0, 0, 25, 0, 7, 32
"/home/wzliu/PCNL_XuanCe/XuanPolicy_Library/xuanpolicy/xuanpolicy/configs/perdqn/atari.yaml", "YAML", 0, 0, 40, 1, 8, 49
"/home/wzliu/PCNL_XuanCe/XuanPolicy_Library/xuanpolicy/xuanpolicy/configs/perdqn/box2d/CarRacing-v2.yaml", "YAML", 0, 0, 34, 1, 8, 43
"/home/wzliu/PCNL_XuanCe/XuanPolicy_Library/xuanpolicy/xuanpolicy/configs/perdqn/box2d/LunarLander-v2.yaml", "YAML", 0, 0, 32, 0, 7, 39
"/home/wzliu/PCNL_XuanCe/XuanPolicy_Library/xuanpolicy/xuanpolicy/configs/perdqn/classic_control/Acrobot-v1.yaml", "YAML", 0, 0, 32, 0, 7, 39
"/home/wzliu/PCNL_XuanCe/XuanPolicy_Library/xuanpolicy/xuanpolicy/configs/perdqn/classic_control/CartPole-v1.yaml", "YAML", 0, 0, 32, 0, 7, 39
"/home/wzliu/PCNL_XuanCe/XuanPolicy_Library/xuanpolicy/xuanpolicy/configs/perdqn/classic_control/MountainCar-v1.yaml", "YAML", 0, 0, 32, 0, 7, 39
"/home/wzliu/PCNL_XuanCe/XuanPolicy_Library/xuanpolicy/xuanpolicy/configs/pg/box2d/BipedalWalker-v3.yaml", "YAML", 0, 0, 31, 0, 5, 36
"/home/wzliu/PCNL_XuanCe/XuanPolicy_Library/xuanpolicy/xuanpolicy/configs/pg/box2d/LunarLander-v2.yaml", "YAML", 0, 0, 31, 0, 5, 36
"/home/wzliu/PCNL_XuanCe/XuanPolicy_Library/xuanpolicy/xuanpolicy/configs/pg/classic_control/Acrobot-v1.yaml", "YAML", 0, 0, 31, 0, 5, 36
"/home/wzliu/PCNL_XuanCe/XuanPolicy_Library/xuanpolicy/xuanpolicy/configs/pg/classic_control/CartPole-v1.yaml", "YAML", 0, 0, 31, 0, 5, 36
"/home/wzliu/PCNL_XuanCe/XuanPolicy_Library/xuanpolicy/xuanpolicy/configs/pg/classic_control/MountainCar-v0.yaml", "YAML", 0, 0, 31, 0, 6, 37
"/home/wzliu/PCNL_XuanCe/XuanPolicy_Library/xuanpolicy/xuanpolicy/configs/pg/classic_control/Pendulum-v1.yaml", "YAML", 0, 0, 31, 0, 5, 36
"/home/wzliu/PCNL_XuanCe/XuanPolicy_Library/xuanpolicy/xuanpolicy/configs/pg/mujoco.yaml", "YAML", 0, 0, 31, 0, 5, 36
"/home/wzliu/PCNL_XuanCe/XuanPolicy_Library/xuanpolicy/xuanpolicy/configs/ppg/box2d/BipedalWalker-v3.yaml", "YAML", 0, 0, 35, 0, 6, 41
"/home/wzliu/PCNL_XuanCe/XuanPolicy_Library/xuanpolicy/xuanpolicy/configs/ppg/box2d/LunarLander-v2.yaml", "YAML", 0, 0, 35, 0, 5, 40
"/home/wzliu/PCNL_XuanCe/XuanPolicy_Library/xuanpolicy/xuanpolicy/configs/ppg/classic_control/Acrobot-v1.yaml", "YAML", 0, 0, 35, 0, 6, 41
"/home/wzliu/PCNL_XuanCe/XuanPolicy_Library/xuanpolicy/xuanpolicy/configs/ppg/classic_control/CartPole-v1.yaml", "YAML", 0, 0, 35, 0, 5, 40
"/home/wzliu/PCNL_XuanCe/XuanPolicy_Library/xuanpolicy/xuanpolicy/configs/ppg/classic_control/MountainCar-v0.yaml", "YAML", 0, 0, 35, 0, 6, 41
"/home/wzliu/PCNL_XuanCe/XuanPolicy_Library/xuanpolicy/xuanpolicy/configs/ppg/classic_control/Pendulum-v1.yaml", "YAML", 0, 0, 35, 0, 6, 41
"/home/wzliu/PCNL_XuanCe/XuanPolicy_Library/xuanpolicy/xuanpolicy/configs/ppg/mujoco.yaml", "YAML", 0, 0, 35, 0, 7, 42
"/home/wzliu/PCNL_XuanCe/XuanPolicy_Library/xuanpolicy/xuanpolicy/configs/ppo/atari.yaml", "YAML", 0, 0, 43, 1, 7, 51
"/home/wzliu/PCNL_XuanCe/XuanPolicy_Library/xuanpolicy/xuanpolicy/configs/ppo/box2d/BipedalWalker-v3.yaml", "YAML", 0, 0, 35, 0, 6, 41
"/home/wzliu/PCNL_XuanCe/XuanPolicy_Library/xuanpolicy/xuanpolicy/configs/ppo/box2d/CarRacing-v2.yaml", "YAML", 0, 0, 37, 1, 6, 44
"/home/wzliu/PCNL_XuanCe/XuanPolicy_Library/xuanpolicy/xuanpolicy/configs/ppo/box2d/LunarLander-v2.yaml", "YAML", 0, 0, 35, 0, 6, 41
"/home/wzliu/PCNL_XuanCe/XuanPolicy_Library/xuanpolicy/xuanpolicy/configs/ppo/classic_control/Acrobot-v1.yaml", "YAML", 0, 0, 35, 0, 7, 42
"/home/wzliu/PCNL_XuanCe/XuanPolicy_Library/xuanpolicy/xuanpolicy/configs/ppo/classic_control/CartPole-v1.yaml", "YAML", 0, 0, 35, 0, 7, 42
"/home/wzliu/PCNL_XuanCe/XuanPolicy_Library/xuanpolicy/xuanpolicy/configs/ppo/classic_control/MountainCar-v0.yaml", "YAML", 0, 0, 35, 0, 7, 42
"/home/wzliu/PCNL_XuanCe/XuanPolicy_Library/xuanpolicy/xuanpolicy/configs/ppo/classic_control/Pendulum-v1.yaml", "YAML", 0, 0, 35, 0, 7, 42
"/home/wzliu/PCNL_XuanCe/XuanPolicy_Library/xuanpolicy/xuanpolicy/configs/ppo/mujoco.yaml", "YAML", 0, 0, 35, 0, 7, 42
"/home/wzliu/PCNL_XuanCe/XuanPolicy_Library/xuanpolicy/xuanpolicy/configs/qmix/mpe/simple_spread_v3.yaml", "YAML", 0, 0, 37, 0, 7, 44
"/home/wzliu/PCNL_XuanCe/XuanPolicy_Library/xuanpolicy/xuanpolicy/configs/qmix/sc2/25m.yaml", "YAML", 0, 0, 43, 1, 8, 52
"/home/wzliu/PCNL_XuanCe/XuanPolicy_Library/xuanpolicy/xuanpolicy/configs/qmix/sc2/2m_vs_1z.yaml", "YAML", 0, 0, 43, 1, 8, 52
"/home/wzliu/PCNL_XuanCe/XuanPolicy_Library/xuanpolicy/xuanpolicy/configs/qmix/sc2/3m.yaml", "YAML", 0, 0, 43, 1, 8, 52
"/home/wzliu/PCNL_XuanCe/XuanPolicy_Library/xuanpolicy/xuanpolicy/configs/qmix/sc2/5m_vs_6m.yaml", "YAML", 0, 0, 43, 1, 8, 52
"/home/wzliu/PCNL_XuanCe/XuanPolicy_Library/xuanpolicy/xuanpolicy/configs/qmix/sc2/8m.yaml", "YAML", 0, 0, 43, 1, 8, 52
"/home/wzliu/PCNL_XuanCe/XuanPolicy_Library/xuanpolicy/xuanpolicy/configs/qmix/sc2/8m_vs_9m.yaml", "YAML", 0, 0, 43, 1, 8, 52
"/home/wzliu/PCNL_XuanCe/XuanPolicy_Library/xuanpolicy/xuanpolicy/configs/qmix/sc2/MMM2.yaml", "YAML", 0, 0, 43, 1, 8, 52
"/home/wzliu/PCNL_XuanCe/XuanPolicy_Library/xuanpolicy/xuanpolicy/configs/qmix/sc2/corridor.yaml", "YAML", 0, 0, 43, 1, 8, 52
"/home/wzliu/PCNL_XuanCe/XuanPolicy_Library/xuanpolicy/xuanpolicy/configs/qrdqn/atari.yaml", "YAML", 0, 0, 39, 1, 7, 47
"/home/wzliu/PCNL_XuanCe/XuanPolicy_Library/xuanpolicy/xuanpolicy/configs/qrdqn/box2d/CarRacing-v2.yaml", "YAML", 0, 0, 33, 1, 7, 41
"/home/wzliu/PCNL_XuanCe/XuanPolicy_Library/xuanpolicy/xuanpolicy/configs/qrdqn/box2d/LunarLander-v2.yaml", "YAML", 0, 0, 31, 0, 6, 37
"/home/wzliu/PCNL_XuanCe/XuanPolicy_Library/xuanpolicy/xuanpolicy/configs/qrdqn/classic_control/Acrobot-v1.yaml", "YAML", 0, 0, 31, 0, 6, 37
"/home/wzliu/PCNL_XuanCe/XuanPolicy_Library/xuanpolicy/xuanpolicy/configs/qrdqn/classic_control/CartPole-v1.yaml", "YAML", 0, 0, 31, 0, 6, 37
"/home/wzliu/PCNL_XuanCe/XuanPolicy_Library/xuanpolicy/xuanpolicy/configs/qrdqn/classic_control/MountainCar-v0.yaml", "YAML", 0, 0, 31, 0, 6, 37
"/home/wzliu/PCNL_XuanCe/XuanPolicy_Library/xuanpolicy/xuanpolicy/configs/qtran/mpe/simple_spread_v3.yaml", "YAML", 0, 0, 28, 0, 6, 34
"/home/wzliu/PCNL_XuanCe/XuanPolicy_Library/xuanpolicy/xuanpolicy/configs/random/mpe/simple_adversary.yaml", "YAML", 0, 0, 7, 0, 1, 8
"/home/wzliu/PCNL_XuanCe/XuanPolicy_Library/xuanpolicy/xuanpolicy/configs/random/mpe/simple_push.yaml", "YAML", 0, 0, 7, 0, 1, 8
"/home/wzliu/PCNL_XuanCe/XuanPolicy_Library/xuanpolicy/xuanpolicy/configs/random/mpe/simple_spread.yaml", "YAML", 0, 0, 7, 0, 1, 8
"/home/wzliu/PCNL_XuanCe/XuanPolicy_Library/xuanpolicy/xuanpolicy/configs/sac/atari.yaml", "YAML", 0, 0, 41, 0, 6, 47
"/home/wzliu/PCNL_XuanCe/XuanPolicy_Library/xuanpolicy/xuanpolicy/configs/sac/box2d/BipedalWalker-v3.yaml", "YAML", 0, 0, 31, 0, 6, 37
"/home/wzliu/PCNL_XuanCe/XuanPolicy_Library/xuanpolicy/xuanpolicy/configs/sac/box2d/LunarLander-v2.yaml", "YAML", 0, 0, 32, 0, 6, 38
"/home/wzliu/PCNL_XuanCe/XuanPolicy_Library/xuanpolicy/xuanpolicy/configs/sac/classic_control/Acrobot-v1.yaml", "YAML", 0, 0, 32, 0, 6, 38
"/home/wzliu/PCNL_XuanCe/XuanPolicy_Library/xuanpolicy/xuanpolicy/configs/sac/classic_control/CartPole-v1.yaml", "YAML", 0, 0, 32, 0, 6, 38
"/home/wzliu/PCNL_XuanCe/XuanPolicy_Library/xuanpolicy/xuanpolicy/configs/sac/classic_control/MountainCar-v0.yaml", "YAML", 0, 0, 32, 0, 6, 38
"/home/wzliu/PCNL_XuanCe/XuanPolicy_Library/xuanpolicy/xuanpolicy/configs/sac/classic_control/Pendulum-v1.yaml", "YAML", 0, 0, 31, 0, 6, 37
"/home/wzliu/PCNL_XuanCe/XuanPolicy_Library/xuanpolicy/xuanpolicy/configs/sac/mujoco.yaml", "YAML", 0, 0, 33, 0, 6, 39
"/home/wzliu/PCNL_XuanCe/XuanPolicy_Library/xuanpolicy/xuanpolicy/configs/spdqn/Platform-v0.yaml", "YAML", 0, 0, 25, 0, 7, 32
"/home/wzliu/PCNL_XuanCe/XuanPolicy_Library/xuanpolicy/xuanpolicy/configs/td3/box2d/BipedalWalker-v3.yaml", "YAML", 0, 0, 31, 0, 5, 36
"/home/wzliu/PCNL_XuanCe/XuanPolicy_Library/xuanpolicy/xuanpolicy/configs/td3/classic_control/Pendulum-v1.yaml", "YAML", 0, 0, 31, 0, 5, 36
"/home/wzliu/PCNL_XuanCe/XuanPolicy_Library/xuanpolicy/xuanpolicy/configs/td3/mujoco.yaml", "YAML", 0, 0, 31, 0, 6, 37
"/home/wzliu/PCNL_XuanCe/XuanPolicy_Library/xuanpolicy/xuanpolicy/configs/vdac/mpe/simple_spread_v3.yaml", "YAML", 0, 0, 41, 1, 8, 50
"/home/wzliu/PCNL_XuanCe/XuanPolicy_Library/xuanpolicy/xuanpolicy/configs/vdn/football/3v1.yaml", "YAML", 0, 0, 49, 2, 7, 58
"/home/wzliu/PCNL_XuanCe/XuanPolicy_Library/xuanpolicy/xuanpolicy/configs/vdn/mpe/simple_spread_v3.yaml", "YAML", 0, 0, 35, 0, 6, 41
"/home/wzliu/PCNL_XuanCe/XuanPolicy_Library/xuanpolicy/xuanpolicy/configs/vdn/sc2/25m.yaml", "YAML", 0, 0, 41, 1, 7, 49
"/home/wzliu/PCNL_XuanCe/XuanPolicy_Library/xuanpolicy/xuanpolicy/configs/vdn/sc2/2m_vs_1z.yaml", "YAML", 0, 0, 41, 1, 7, 49
"/home/wzliu/PCNL_XuanCe/XuanPolicy_Library/xuanpolicy/xuanpolicy/configs/vdn/sc2/3m.yaml", "YAML", 0, 0, 41, 1, 7, 49
"/home/wzliu/PCNL_XuanCe/XuanPolicy_Library/xuanpolicy/xuanpolicy/configs/vdn/sc2/5m_vs_6m.yaml", "YAML", 0, 0, 41, 1, 7, 49
"/home/wzliu/PCNL_XuanCe/XuanPolicy_Library/xuanpolicy/xuanpolicy/configs/vdn/sc2/8m.yaml", "YAML", 0, 0, 41, 1, 7, 49
"/home/wzliu/PCNL_XuanCe/XuanPolicy_Library/xuanpolicy/xuanpolicy/configs/vdn/sc2/8m_vs_9m.yaml", "YAML", 0, 0, 41, 1, 7, 49
"/home/wzliu/PCNL_XuanCe/XuanPolicy_Library/xuanpolicy/xuanpolicy/configs/vdn/sc2/MMM2.yaml", "YAML", 0, 0, 41, 1, 7, 49
"/home/wzliu/PCNL_XuanCe/XuanPolicy_Library/xuanpolicy/xuanpolicy/configs/vdn/sc2/corridor.yaml", "YAML", 0, 0, 41, 1, 7, 49
"/home/wzliu/PCNL_XuanCe/XuanPolicy_Library/xuanpolicy/xuanpolicy/configs/wqmix/mpe/simple_spread_v3.yaml", "YAML", 0, 0, 38, 0, 6, 44
"/home/wzliu/PCNL_XuanCe/XuanPolicy_Library/xuanpolicy/xuanpolicy/configs/wqmix/sc2/25m.yaml", "YAML", 0, 0, 44, 1, 9, 54
"/home/wzliu/PCNL_XuanCe/XuanPolicy_Library/xuanpolicy/xuanpolicy/configs/wqmix/sc2/2m_vs_1z.yaml", "YAML", 0, 0, 44, 1, 9, 54
"/home/wzliu/PCNL_XuanCe/XuanPolicy_Library/xuanpolicy/xuanpolicy/configs/wqmix/sc2/3m.yaml", "YAML", 0, 0, 44, 1, 9, 54
"/home/wzliu/PCNL_XuanCe/XuanPolicy_Library/xuanpolicy/xuanpolicy/configs/wqmix/sc2/5m_vs_6m.yaml", "YAML", 0, 0, 44, 1, 9, 54
"/home/wzliu/PCNL_XuanCe/XuanPolicy_Library/xuanpolicy/xuanpolicy/configs/wqmix/sc2/8m.yaml", "YAML", 0, 0, 44, 1, 9, 54
"/home/wzliu/PCNL_XuanCe/XuanPolicy_Library/xuanpolicy/xuanpolicy/configs/wqmix/sc2/8m_vs_9m.yaml", "YAML", 0, 0, 44, 1, 9, 54
"/home/wzliu/PCNL_XuanCe/XuanPolicy_Library/xuanpolicy/xuanpolicy/configs/wqmix/sc2/MMM2.yaml", "YAML", 0, 0, 44, 1, 9, 54
"/home/wzliu/PCNL_XuanCe/XuanPolicy_Library/xuanpolicy/xuanpolicy/configs/wqmix/sc2/corridor.yaml", "YAML", 0, 0, 44, 1, 9, 54
"/home/wzliu/PCNL_XuanCe/XuanPolicy_Library/xuanpolicy/xuanpolicy/environment/__init__.py", "Python", 60, 0, 0, 0, 8, 68
"/home/wzliu/PCNL_XuanCe/XuanPolicy_Library/xuanpolicy/xuanpolicy/environment/football/__init__.py", "Python", 20, 0, 0, 19, 2, 41
"/home/wzliu/PCNL_XuanCe/XuanPolicy_Library/xuanpolicy/xuanpolicy/environment/football/gfootball_env.py", "Python", 64, 0, 0, 0, 10, 74
"/home/wzliu/PCNL_XuanCe/XuanPolicy_Library/xuanpolicy/xuanpolicy/environment/football/gfootball_vec_env.py", "Python", 81, 0, 0, 0, 9, 90
"/home/wzliu/PCNL_XuanCe/XuanPolicy_Library/xuanpolicy/xuanpolicy/environment/football/raw_env.py", "Python", 90, 0, 0, 2, 11, 103
"/home/wzliu/PCNL_XuanCe/XuanPolicy_Library/xuanpolicy/xuanpolicy/environment/gym/__init__.py", "Python", 0, 0, 0, 0, 1, 1
"/home/wzliu/PCNL_XuanCe/XuanPolicy_Library/xuanpolicy/xuanpolicy/environment/gym/gym_env.py", "Python", 180, 0, 0, 41, 33, 254
"/home/wzliu/PCNL_XuanCe/XuanPolicy_Library/xuanpolicy/xuanpolicy/environment/gym/gym_vec_env.py", "Python", 196, 0, 0, 17, 28, 241
"/home/wzliu/PCNL_XuanCe/XuanPolicy_Library/xuanpolicy/xuanpolicy/environment/magent2/__init__.py", "Python", 19, 0, 0, 1, 7, 27
"/home/wzliu/PCNL_XuanCe/XuanPolicy_Library/xuanpolicy/xuanpolicy/environment/magent2/build.sh", "Shell Script", 0, 13, 0, 3, 3, 19
"/home/wzliu/PCNL_XuanCe/XuanPolicy_Library/xuanpolicy/xuanpolicy/environment/magent2/builtin/__init__.py", "Python", 0, 0, 0, 0, 1, 1
"/home/wzliu/PCNL_XuanCe/XuanPolicy_Library/xuanpolicy/xuanpolicy/environment/magent2/builtin/config/__init__.py", "Python", 0, 0, 0, 0, 1, 1
"/home/wzliu/PCNL_XuanCe/XuanPolicy_Library/xuanpolicy/xuanpolicy/environment/magent2/builtin/config/battle.py", "Python", 31, 0, 0, 2, 10, 43
"/home/wzliu/PCNL_XuanCe/XuanPolicy_Library/xuanpolicy/xuanpolicy/environment/magent2/builtin/config/double_attack.py", "Python", 41, 0, 0, 4, 11, 56
"/home/wzliu/PCNL_XuanCe/XuanPolicy_Library/xuanpolicy/xuanpolicy/environment/magent2/builtin/config/forest.py", "Python", 41, 0, 0, 1, 10, 52
"/home/wzliu/PCNL_XuanCe/XuanPolicy_Library/xuanpolicy/xuanpolicy/environment/magent2/builtin/config/pursuit.py", "Python", 34, 0, 0, 0, 10, 44
"/home/wzliu/PCNL_XuanCe/XuanPolicy_Library/xuanpolicy/xuanpolicy/environment/magent2/c_lib.py", "Python", 26, 0, 0, 5, 13, 44
"/home/wzliu/PCNL_XuanCe/XuanPolicy_Library/xuanpolicy/xuanpolicy/environment/magent2/environment.py", "Python", 25, 0, 0, 4, 15, 44
"/home/wzliu/PCNL_XuanCe/XuanPolicy_Library/xuanpolicy/xuanpolicy/environment/magent2/environments/__init__.py", "Python", 3, 0, 0, 0, 3, 6
"/home/wzliu/PCNL_XuanCe/XuanPolicy_Library/xuanpolicy/xuanpolicy/environment/magent2/environments/adversarial_pursuit/__init__.py", "Python", 1, 0, 0, 0, 1, 2
"/home/wzliu/PCNL_XuanCe/XuanPolicy_Library/xuanpolicy/xuanpolicy/environment/magent2/environments/adversarial_pursuit/adversarial_pursuit.py", "Python", 130, 0, 0, 100, 26, 256
"/home/wzliu/PCNL_XuanCe/XuanPolicy_Library/xuanpolicy/xuanpolicy/environment/magent2/environments/adversarial_pursuit_v4.py", "Python", 5, 0, 0, 0, 1, 6
"/home/wzliu/PCNL_XuanCe/XuanPolicy_Library/xuanpolicy/xuanpolicy/environment/magent2/environments/battle/__init__.py", "Python", 1, 0, 0, 0, 1, 2
"/home/wzliu/PCNL_XuanCe/XuanPolicy_Library/xuanpolicy/xuanpolicy/environment/magent2/environments/battle/battle.py", "Python", 164, 0, 0, 115, 27, 306
"/home/wzliu/PCNL_XuanCe/XuanPolicy_Library/xuanpolicy/xuanpolicy/environment/magent2/environments/battle_v4.py", "Python", 1, 0, 0, 0, 1, 2
"/home/wzliu/PCNL_XuanCe/XuanPolicy_Library/xuanpolicy/xuanpolicy/environment/magent2/environments/battlefield/__init__.py", "Python", 1, 0, 0, 0, 1, 2
"/home/wzliu/PCNL_XuanCe/XuanPolicy_Library/xuanpolicy/xuanpolicy/environment/magent2/environments/battlefield/battlefield.py", "Python", 146, 0, 0, 116, 26, 288
"/home/wzliu/PCNL_XuanCe/XuanPolicy_Library/xuanpolicy/xuanpolicy/environment/magent2/environments/battlefield_v5.py", "Python", 1, 0, 0, 0, 1, 2
"/home/wzliu/PCNL_XuanCe/XuanPolicy_Library/xuanpolicy/xuanpolicy/environment/magent2/environments/combined_arms/__init__.py", "Python", 1, 0, 0, 0, 1, 2
"/home/wzliu/PCNL_XuanCe/XuanPolicy_Library/xuanpolicy/xuanpolicy/environment/magent2/environments/combined_arms/combined_arms.py", "Python", 259, 0, 0, 118, 38, 415
"/home/wzliu/PCNL_XuanCe/XuanPolicy_Library/xuanpolicy/xuanpolicy/environment/magent2/environments/combined_arms_v6.py", "Python", 1, 0, 0, 0, 1, 2
"/home/wzliu/PCNL_XuanCe/XuanPolicy_Library/xuanpolicy/xuanpolicy/environment/magent2/environments/gather/__init__.py", "Python", 1, 0, 0, 0, 1, 2
"/home/wzliu/PCNL_XuanCe/XuanPolicy_Library/xuanpolicy/xuanpolicy/environment/magent2/environments/gather/gather.py", "Python", 186, 0, 0, 105, 33, 324
"/home/wzliu/PCNL_XuanCe/XuanPolicy_Library/xuanpolicy/xuanpolicy/environment/magent2/environments/gather_v5.py", "Python", 1, 0, 0, 0, 1, 2
"/home/wzliu/PCNL_XuanCe/XuanPolicy_Library/xuanpolicy/xuanpolicy/environment/magent2/environments/magent_env.py", "Python", 247, 0, 0, 6, 38, 291
"/home/wzliu/PCNL_XuanCe/XuanPolicy_Library/xuanpolicy/xuanpolicy/environment/magent2/environments/tiger_deer/__init__.py", "Python", 1, 0, 0, 0, 1, 2
"/home/wzliu/PCNL_XuanCe/XuanPolicy_Library/xuanpolicy/xuanpolicy/environment/magent2/environments/tiger_deer/tiger_deer.py", "Python", 141, 0, 0, 88, 28, 257
"/home/wzliu/PCNL_XuanCe/XuanPolicy_Library/xuanpolicy/xuanpolicy/environment/magent2/environments/tiger_deer_v4.py", "Python", 1, 0, 0, 0, 1, 2
"/home/wzliu/PCNL_XuanCe/XuanPolicy_Library/xuanpolicy/xuanpolicy/environment/magent2/gridworld.py", "Python", 531, 0, 0, 287, 98, 916
"/home/wzliu/PCNL_XuanCe/XuanPolicy_Library/xuanpolicy/xuanpolicy/environment/magent2/magent_env.py", "Python", 58, 0, 0, 0, 12, 70
"/home/wzliu/PCNL_XuanCe/XuanPolicy_Library/xuanpolicy/xuanpolicy/environment/magent2/magent_vec_env.py", "Python", 124, 0, 0, 7, 23, 154
"/home/wzliu/PCNL_XuanCe/XuanPolicy_Library/xuanpolicy/xuanpolicy/environment/magent2/render.py", "Python", 289, 0, 0, 2, 47, 338
"/home/wzliu/PCNL_XuanCe/XuanPolicy_Library/xuanpolicy/xuanpolicy/environment/magent2/utility.py", "Python", 81, 0, 0, 16, 23, 120
"/home/wzliu/PCNL_XuanCe/XuanPolicy_Library/xuanpolicy/xuanpolicy/environment/pettingzoo/__init__.py", "Python", 23, 0, 0, 0, 2, 25
"/home/wzliu/PCNL_XuanCe/XuanPolicy_Library/xuanpolicy/xuanpolicy/environment/pettingzoo/pettingzoo_env.py", "Python", 90, 0, 0, 3, 17, 110
"/home/wzliu/PCNL_XuanCe/XuanPolicy_Library/xuanpolicy/xuanpolicy/environment/pettingzoo/pettingzoo_vec_env.py", "Python", 130, 0, 0, 5, 22, 157
"/home/wzliu/PCNL_XuanCe/XuanPolicy_Library/xuanpolicy/xuanpolicy/environment/starcraft2/__init__.py", "Python", 0, 0, 0, 0, 1, 1
"/home/wzliu/PCNL_XuanCe/XuanPolicy_Library/xuanpolicy/xuanpolicy/environment/starcraft2/sc2_env.py", "Python", 54, 0, 0, 0, 11, 65
"/home/wzliu/PCNL_XuanCe/XuanPolicy_Library/xuanpolicy/xuanpolicy/environment/starcraft2/sc2_vec_env.py", "Python", 261, 0, 0, 12, 30, 303
"/home/wzliu/PCNL_XuanCe/XuanPolicy_Library/xuanpolicy/xuanpolicy/environment/vector_envs/__init__.py", "Python", 0, 0, 0, 0, 1, 1
"/home/wzliu/PCNL_XuanCe/XuanPolicy_Library/xuanpolicy/xuanpolicy/environment/vector_envs/env_utils.py", "Python", 100, 0, 0, 11, 26, 137
"/home/wzliu/PCNL_XuanCe/XuanPolicy_Library/xuanpolicy/xuanpolicy/environment/vector_envs/subproc_vec_env.py", "Python", 132, 0, 0, 18, 26, 176
"/home/wzliu/PCNL_XuanCe/XuanPolicy_Library/xuanpolicy/xuanpolicy/environment/vector_envs/vector_env.py", "Python", 60, 0, 0, 28, 16, 104
"/home/wzliu/PCNL_XuanCe/XuanPolicy_Library/xuanpolicy/xuanpolicy/mindspore/__init__.py", "Python", 0, 0, 0, 0, 1, 1
"/home/wzliu/PCNL_XuanCe/XuanPolicy_Library/xuanpolicy/xuanpolicy/mindspore/agents/__init__.py", "Python", 111, 0, 0, 0, 6, 117
"/home/wzliu/PCNL_XuanCe/XuanPolicy_Library/xuanpolicy/xuanpolicy/mindspore/agents/agent.py", "Python", 39, 0, 0, 0, 10, 49
"/home/wzliu/PCNL_XuanCe/XuanPolicy_Library/xuanpolicy/xuanpolicy/mindspore/agents/agents_marl.py", "Python", 88, 0, 0, 0, 18, 106
"/home/wzliu/PCNL_XuanCe/XuanPolicy_Library/xuanpolicy/xuanpolicy/mindspore/agents/multi_agent_rl/__init__.py", "Python", 0, 0, 0, 0, 1, 1
"/home/wzliu/PCNL_XuanCe/XuanPolicy_Library/xuanpolicy/xuanpolicy/mindspore/agents/multi_agent_rl/coma_agents.py", "Python", 90, 0, 0, 1, 13, 104
"/home/wzliu/PCNL_XuanCe/XuanPolicy_Library/xuanpolicy/xuanpolicy/mindspore/agents/multi_agent_rl/dcg_agents.py", "Python", 86, 0, 0, 0, 12, 98
"/home/wzliu/PCNL_XuanCe/XuanPolicy_Library/xuanpolicy/xuanpolicy/mindspore/agents/multi_agent_rl/iddpg_agents.py", "Python", 80, 0, 0, 0, 11, 91
"/home/wzliu/PCNL_XuanCe/XuanPolicy_Library/xuanpolicy/xuanpolicy/mindspore/agents/multi_agent_rl/iql_agents.py", "Python", 71, 0, 0, 0, 13, 84
"/home/wzliu/PCNL_XuanCe/XuanPolicy_Library/xuanpolicy/xuanpolicy/mindspore/agents/multi_agent_rl/isac_agents.py", "Python", 79, 0, 0, 0, 11, 90
"/home/wzliu/PCNL_XuanCe/XuanPolicy_Library/xuanpolicy/xuanpolicy/mindspore/agents/multi_agent_rl/maddpg_agents.py", "Python", 80, 0, 0, 0, 11, 91
"/home/wzliu/PCNL_XuanCe/XuanPolicy_Library/xuanpolicy/xuanpolicy/mindspore/agents/multi_agent_rl/mappoclip_agents.py", "Python", 83, 0, 0, 0, 14, 97
"/home/wzliu/PCNL_XuanCe/XuanPolicy_Library/xuanpolicy/xuanpolicy/mindspore/agents/multi_agent_rl/mappokl_agents.py", "Python", 84, 0, 0, 1, 14, 99
"/home/wzliu/PCNL_XuanCe/XuanPolicy_Library/xuanpolicy/xuanpolicy/mindspore/agents/multi_agent_rl/masac_agents.py", "Python", 79, 0, 0, 0, 11, 90
"/home/wzliu/PCNL_XuanCe/XuanPolicy_Library/xuanpolicy/xuanpolicy/mindspore/agents/multi_agent_rl/matd3_agents.py", "Python", 84, 0, 0, 0, 12, 96
"/home/wzliu/PCNL_XuanCe/XuanPolicy_Library/xuanpolicy/xuanpolicy/mindspore/agents/multi_agent_rl/mfac_agents.py", "Python", 93, 0, 0, 1, 16, 110
"/home/wzliu/PCNL_XuanCe/XuanPolicy_Library/xuanpolicy/xuanpolicy/mindspore/agents/multi_agent_rl/mfq_agents.py", "Python", 97, 0, 0, 0, 13, 110
"/home/wzliu/PCNL_XuanCe/XuanPolicy_Library/xuanpolicy/xuanpolicy/mindspore/agents/multi_agent_rl/qmix_agents.py", "Python", 73, 0, 0, 0, 12, 85
"/home/wzliu/PCNL_XuanCe/XuanPolicy_Library/xuanpolicy/xuanpolicy/mindspore/agents/multi_agent_rl/qtran_agents.py", "Python", 81, 0, 0, 0, 13, 94
"/home/wzliu/PCNL_XuanCe/XuanPolicy_Library/xuanpolicy/xuanpolicy/mindspore/agents/multi_agent_rl/vdac_agents.py", "Python", 91, 0, 0, 0, 14, 105
"/home/wzliu/PCNL_XuanCe/XuanPolicy_Library/xuanpolicy/xuanpolicy/mindspore/agents/multi_agent_rl/vdn_agents.py", "Python", 72, 0, 0, 0, 12, 84
"/home/wzliu/PCNL_XuanCe/XuanPolicy_Library/xuanpolicy/xuanpolicy/mindspore/agents/multi_agent_rl/wqmix_agents.py", "Python", 76, 0, 0, 0, 12, 88
"/home/wzliu/PCNL_XuanCe/XuanPolicy_Library/xuanpolicy/xuanpolicy/mindspore/agents/policy_gradient/__init__.py", "Python", 0, 0, 0, 0, 1, 1
"/home/wzliu/PCNL_XuanCe/XuanPolicy_Library/xuanpolicy/xuanpolicy/mindspore/agents/policy_gradient/a2c_agent.py", "Python", 128, 0, 0, 0, 15, 143
"/home/wzliu/PCNL_XuanCe/XuanPolicy_Library/xuanpolicy/xuanpolicy/mindspore/agents/policy_gradient/ddpg_agent.py", "Python", 122, 0, 0, 0, 14, 136
"/home/wzliu/PCNL_XuanCe/XuanPolicy_Library/xuanpolicy/xuanpolicy/mindspore/agents/policy_gradient/mpdqn_agent.py", "Python", 165, 0, 0, 1, 19, 185
"/home/wzliu/PCNL_XuanCe/XuanPolicy_Library/xuanpolicy/xuanpolicy/mindspore/agents/policy_gradient/pdqn_agent.py", "Python", 153, 0, 0, 1, 18, 172
"/home/wzliu/PCNL_XuanCe/XuanPolicy_Library/xuanpolicy/xuanpolicy/mindspore/agents/policy_gradient/pg_agent.py", "Python", 125, 0, 0, 0, 15, 140
"/home/wzliu/PCNL_XuanCe/XuanPolicy_Library/xuanpolicy/xuanpolicy/mindspore/agents/policy_gradient/ppg_agent.py", "Python", 145, 0, 0, 5, 19, 169
"/home/wzliu/PCNL_XuanCe/XuanPolicy_Library/xuanpolicy/xuanpolicy/mindspore/agents/policy_gradient/ppoclip_agent.py", "Python", 129, 0, 0, 0, 17, 146
"/home/wzliu/PCNL_XuanCe/XuanPolicy_Library/xuanpolicy/xuanpolicy/mindspore/agents/policy_gradient/ppokl_agent.py", "Python", 129, 0, 0, 0, 17, 146
"/home/wzliu/PCNL_XuanCe/XuanPolicy_Library/xuanpolicy/xuanpolicy/mindspore/agents/policy_gradient/sac_agent.py", "Python", 121, 0, 0, 0, 17, 138
"/home/wzliu/PCNL_XuanCe/XuanPolicy_Library/xuanpolicy/xuanpolicy/mindspore/agents/policy_gradient/sacdis_agent.py", "Python", 120, 0, 0, 2, 17, 139
"/home/wzliu/PCNL_XuanCe/XuanPolicy_Library/xuanpolicy/xuanpolicy/mindspore/agents/policy_gradient/spdqn_agent.py", "Python", 172, 0, 0, 1, 20, 193
"/home/wzliu/PCNL_XuanCe/XuanPolicy_Library/xuanpolicy/xuanpolicy/mindspore/agents/policy_gradient/td3_agent.py", "Python", 123, 0, 0, 0, 14, 137
"/home/wzliu/PCNL_XuanCe/XuanPolicy_Library/xuanpolicy/xuanpolicy/mindspore/agents/qlearning_family/C51_agent.py", "Python", 125, 0, 0, 1, 20, 146
"/home/wzliu/PCNL_XuanCe/XuanPolicy_Library/xuanpolicy/xuanpolicy/mindspore/agents/qlearning_family/__init__.py", "Python", 0, 0, 0, 0, 1, 1
"/home/wzliu/PCNL_XuanCe/XuanPolicy_Library/xuanpolicy/xuanpolicy/mindspore/agents/qlearning_family/cdqn_agent.py", "Python", 125, 0, 0, 1, 20, 146
"/home/wzliu/PCNL_XuanCe/XuanPolicy_Library/xuanpolicy/xuanpolicy/mindspore/agents/qlearning_family/cldqn_agent.py", "Python", 125, 0, 0, 1, 20, 146
"/home/wzliu/PCNL_XuanCe/XuanPolicy_Library/xuanpolicy/xuanpolicy/mindspore/agents/qlearning_family/ddqn_agent.py", "Python", 125, 0, 0, 1, 20, 146
"/home/wzliu/PCNL_XuanCe/XuanPolicy_Library/xuanpolicy/xuanpolicy/mindspore/agents/qlearning_family/dqn_agent.py", "Python", 125, 0, 0, 1, 20, 146
"/home/wzliu/PCNL_XuanCe/XuanPolicy_Library/xuanpolicy/xuanpolicy/mindspore/agents/qlearning_family/dueldqn_agent.py", "Python", 126, 0, 0, 1, 20, 147
"/home/wzliu/PCNL_XuanCe/XuanPolicy_Library/xuanpolicy/xuanpolicy/mindspore/agents/qlearning_family/ldqn_agent.py", "Python", 125, 0, 0, 1, 20, 146
"/home/wzliu/PCNL_XuanCe/XuanPolicy_Library/xuanpolicy/xuanpolicy/mindspore/agents/qlearning_family/noisydqn_agent.py", "Python", 124, 0, 0, 1, 21, 146
"/home/wzliu/PCNL_XuanCe/XuanPolicy_Library/xuanpolicy/xuanpolicy/mindspore/agents/qlearning_family/perdqn_agent.py", "Python", 130, 0, 0, 1, 22, 153
"/home/wzliu/PCNL_XuanCe/XuanPolicy_Library/xuanpolicy/xuanpolicy/mindspore/agents/qlearning_family/qrdqn_agent.py", "Python", 125, 0, 0, 1, 20, 146
"/home/wzliu/PCNL_XuanCe/XuanPolicy_Library/xuanpolicy/xuanpolicy/mindspore/learners/__init__.py", "Python", 49, 0, 0, 0, 4, 53
"/home/wzliu/PCNL_XuanCe/XuanPolicy_Library/xuanpolicy/xuanpolicy/mindspore/learners/learner.py", "Python", 87, 0, 0, 1, 12, 100
"/home/wzliu/PCNL_XuanCe/XuanPolicy_Library/xuanpolicy/xuanpolicy/mindspore/learners/multi_agent_rl/__init__.py", "Python", 0, 0, 0, 0, 1, 1
"/home/wzliu/PCNL_XuanCe/XuanPolicy_Library/xuanpolicy/xuanpolicy/mindspore/learners/multi_agent_rl/coma_learner.py", "Python", 118, 0, 0, 9, 17, 144
"/home/wzliu/PCNL_XuanCe/XuanPolicy_Library/xuanpolicy/xuanpolicy/mindspore/learners/multi_agent_rl/dcg_learner.py", "Python", 138, 0, 0, 10, 17, 165
"/home/wzliu/PCNL_XuanCe/XuanPolicy_Library/xuanpolicy/xuanpolicy/mindspore/learners/multi_agent_rl/iddpg_learner.py", "Python", 75, 0, 0, 7, 11, 93
"/home/wzliu/PCNL_XuanCe/XuanPolicy_Library/xuanpolicy/xuanpolicy/mindspore/learners/multi_agent_rl/iql_learner.py", "Python", 56, 0, 0, 8, 8, 72
"/home/wzliu/PCNL_XuanCe/XuanPolicy_Library/xuanpolicy/xuanpolicy/mindspore/learners/multi_agent_rl/isac_learner.py", "Python", 84, 0, 0, 7, 13, 104
"/home/wzliu/PCNL_XuanCe/XuanPolicy_Library/xuanpolicy/xuanpolicy/mindspore/learners/multi_agent_rl/maddpg_learner.py", "Python", 80, 0, 0, 10, 10, 100
"/home/wzliu/PCNL_XuanCe/XuanPolicy_Library/xuanpolicy/xuanpolicy/mindspore/learners/multi_agent_rl/mappoclip_learner.py", "Python", 77, 0, 0, 8, 12, 97
"/home/wzliu/PCNL_XuanCe/XuanPolicy_Library/xuanpolicy/xuanpolicy/mindspore/learners/multi_agent_rl/mappokl_learner.py", "Python", 82, 0, 0, 13, 12, 107
"/home/wzliu/PCNL_XuanCe/XuanPolicy_Library/xuanpolicy/xuanpolicy/mindspore/learners/multi_agent_rl/masac_learner.py", "Python", 84, 0, 0, 7, 12, 103
"/home/wzliu/PCNL_XuanCe/XuanPolicy_Library/xuanpolicy/xuanpolicy/mindspore/learners/multi_agent_rl/matd3_learner.py", "Python", 104, 0, 0, 7, 13, 124
"/home/wzliu/PCNL_XuanCe/XuanPolicy_Library/xuanpolicy/xuanpolicy/mindspore/learners/multi_agent_rl/mfac_learner.py", "Python", 103, 0, 0, 10, 14, 127
"/home/wzliu/PCNL_XuanCe/XuanPolicy_Library/xuanpolicy/xuanpolicy/mindspore/learners/multi_agent_rl/mfq_learner.py", "Python", 65, 0, 0, 7, 10, 82
"/home/wzliu/PCNL_XuanCe/XuanPolicy_Library/xuanpolicy/xuanpolicy/mindspore/learners/multi_agent_rl/qmix_learner.py", "Python", 61, 0, 0, 8, 9, 78
"/home/wzliu/PCNL_XuanCe/XuanPolicy_Library/xuanpolicy/xuanpolicy/mindspore/learners/multi_agent_rl/qtran_learner.py", "Python", 98, 0, 0, 7, 14, 119
"/home/wzliu/PCNL_XuanCe/XuanPolicy_Library/xuanpolicy/xuanpolicy/mindspore/learners/multi_agent_rl/vdac_learner.py", "Python", 50, 0, 0, 6, 10, 66
"/home/wzliu/PCNL_XuanCe/XuanPolicy_Library/xuanpolicy/xuanpolicy/mindspore/learners/multi_agent_rl/vdn_learner.py", "Python", 60, 0, 0, 9, 8, 77
"/home/wzliu/PCNL_XuanCe/XuanPolicy_Library/xuanpolicy/xuanpolicy/mindspore/learners/multi_agent_rl/wqmix_learner.py", "Python", 84, 0, 0, 12, 12, 108
"/home/wzliu/PCNL_XuanCe/XuanPolicy_Library/xuanpolicy/xuanpolicy/mindspore/learners/policy_gradient/__init__.py", "Python", 0, 0, 0, 0, 1, 1
"/home/wzliu/PCNL_XuanCe/XuanPolicy_Library/xuanpolicy/xuanpolicy/mindspore/learners/policy_gradient/a2c_learner.py", "Python", 46, 0, 0, 7, 9, 62
"/home/wzliu/PCNL_XuanCe/XuanPolicy_Library/xuanpolicy/xuanpolicy/mindspore/learners/policy_gradient/ddpg_learner.py", "Python", 56, 0, 0, 2, 11, 69
"/home/wzliu/PCNL_XuanCe/XuanPolicy_Library/xuanpolicy/xuanpolicy/mindspore/learners/policy_gradient/mpdqn_learner.py", "Python", 81, 0, 0, 6, 14, 101
"/home/wzliu/PCNL_XuanCe/XuanPolicy_Library/xuanpolicy/xuanpolicy/mindspore/learners/policy_gradient/pdqn_learner.py", "Python", 61, 0, 0, 6, 12, 79
"/home/wzliu/PCNL_XuanCe/XuanPolicy_Library/xuanpolicy/xuanpolicy/mindspore/learners/policy_gradient/pg_learner.py", "Python", 40, 0, 0, 4, 8, 52
"/home/wzliu/PCNL_XuanCe/XuanPolicy_Library/xuanpolicy/xuanpolicy/mindspore/learners/policy_gradient/ppg_learner.py", "Python", 79, 0, 0, 4, 11, 94
"/home/wzliu/PCNL_XuanCe/XuanPolicy_Library/xuanpolicy/xuanpolicy/mindspore/learners/policy_gradient/ppoclip_learner.py", "Python", 51, 0, 0, 8, 7, 66
"/home/wzliu/PCNL_XuanCe/XuanPolicy_Library/xuanpolicy/xuanpolicy/mindspore/learners/policy_gradient/ppokl_learner.py", "Python", 51, 0, 0, 2, 7, 60
"/home/wzliu/PCNL_XuanCe/XuanPolicy_Library/xuanpolicy/xuanpolicy/mindspore/learners/policy_gradient/sac_learner.py", "Python", 55, 0, 0, 1, 12, 68
"/home/wzliu/PCNL_XuanCe/XuanPolicy_Library/xuanpolicy/xuanpolicy/mindspore/learners/policy_gradient/sacdis_learner.py", "Python", 61, 0, 0, 2, 12, 75
"/home/wzliu/PCNL_XuanCe/XuanPolicy_Library/xuanpolicy/xuanpolicy/mindspore/learners/policy_gradient/spdqn_learner.py", "Python", 82, 0, 0, 6, 14, 102
"/home/wzliu/PCNL_XuanCe/XuanPolicy_Library/xuanpolicy/xuanpolicy/mindspore/learners/policy_gradient/td3_learner.py", "Python", 60, 0, 0, 7, 11, 78
"/home/wzliu/PCNL_XuanCe/XuanPolicy_Library/xuanpolicy/xuanpolicy/mindspore/learners/qlearning_family/__init__.py", "Python", 0, 0, 0, 0, 1, 1
"/home/wzliu/PCNL_XuanCe/XuanPolicy_Library/xuanpolicy/xuanpolicy/mindspore/learners/qlearning_family/c51_learner.py", "Python", 59, 0, 0, 4, 15, 78
"/home/wzliu/PCNL_XuanCe/XuanPolicy_Library/xuanpolicy/xuanpolicy/mindspore/learners/qlearning_family/cdqn_learner.py", "Python", 45, 0, 0, 5, 10, 60
"/home/wzliu/PCNL_XuanCe/XuanPolicy_Library/xuanpolicy/xuanpolicy/mindspore/learners/qlearning_family/cldqn_learner.py", "Python", 45, 0, 0, 5, 10, 60
"/home/wzliu/PCNL_XuanCe/XuanPolicy_Library/xuanpolicy/xuanpolicy/mindspore/learners/qlearning_family/ddqn_learner.py", "Python", 48, 0, 0, 2, 11, 61
"/home/wzliu/PCNL_XuanCe/XuanPolicy_Library/xuanpolicy/xuanpolicy/mindspore/learners/qlearning_family/dqn_learner.py", "Python", 45, 0, 0, 5, 10, 60
"/home/wzliu/PCNL_XuanCe/XuanPolicy_Library/xuanpolicy/xuanpolicy/mindspore/learners/qlearning_family/dueldqn_learner.py", "Python", 45, 0, 0, 2, 10, 57
"/home/wzliu/PCNL_XuanCe/XuanPolicy_Library/xuanpolicy/xuanpolicy/mindspore/learners/qlearning_family/ldqn_learner.py", "Python", 45, 0, 0, 5, 10, 60
"/home/wzliu/PCNL_XuanCe/XuanPolicy_Library/xuanpolicy/xuanpolicy/mindspore/learners/qlearning_family/perdqn_learner.py", "Python", 50, 0, 0, 5, 13, 68
"/home/wzliu/PCNL_XuanCe/XuanPolicy_Library/xuanpolicy/xuanpolicy/mindspore/learners/qlearning_family/qrdqn_learner.py", "Python", 54, 0, 0, 5, 11, 70
"/home/wzliu/PCNL_XuanCe/XuanPolicy_Library/xuanpolicy/xuanpolicy/mindspore/policies/__init__.py", "Python", 150, 0, 0, 3, 8, 161
"/home/wzliu/PCNL_XuanCe/XuanPolicy_Library/xuanpolicy/xuanpolicy/mindspore/policies/categorical.py", "Python", 201, 0, 0, 60, 42, 303
"/home/wzliu/PCNL_XuanCe/XuanPolicy_Library/xuanpolicy/xuanpolicy/mindspore/policies/categorical_marl.py", "Python", 252, 0, 0, 1, 39, 292
"/home/wzliu/PCNL_XuanCe/XuanPolicy_Library/xuanpolicy/xuanpolicy/mindspore/policies/deterministic.py", "Python", 716, 0, 0, 20, 108, 844
"/home/wzliu/PCNL_XuanCe/XuanPolicy_Library/xuanpolicy/xuanpolicy/mindspore/policies/deterministic_marl.py", "Python", 440, 0, 0, 3, 70, 513
"/home/wzliu/PCNL_XuanCe/XuanPolicy_Library/xuanpolicy/xuanpolicy/mindspore/policies/gaussian.py", "Python", 207, 0, 0, 12, 35, 254
"/home/wzliu/PCNL_XuanCe/XuanPolicy_Library/xuanpolicy/xuanpolicy/mindspore/policies/gaussian_marl.py", "Python", 247, 0, 0, 5, 43, 295
"/home/wzliu/PCNL_XuanCe/XuanPolicy_Library/xuanpolicy/xuanpolicy/mindspore/policies/mixers.py", "Python", 195, 0, 0, 8, 29, 232
"/home/wzliu/PCNL_XuanCe/XuanPolicy_Library/xuanpolicy/xuanpolicy/mindspore/representations/__init__.py", "Python", 35, 0, 0, 0, 4, 39
"/home/wzliu/PCNL_XuanCe/XuanPolicy_Library/xuanpolicy/xuanpolicy/mindspore/representations/networks.py", "Python", 266, 0, 0, 5, 44, 315
"/home/wzliu/PCNL_XuanCe/XuanPolicy_Library/xuanpolicy/xuanpolicy/mindspore/runners/__init__.py", "Python", 7, 0, 0, 0, 2, 9
"/home/wzliu/PCNL_XuanCe/XuanPolicy_Library/xuanpolicy/xuanpolicy/mindspore/runners/runner_basic.py", "Python", 85, 0, 0, 2, 16, 103
"/home/wzliu/PCNL_XuanCe/XuanPolicy_Library/xuanpolicy/xuanpolicy/mindspore/runners/runner_drl.py", "Python", 71, 0, 0, 0, 8, 79
"/home/wzliu/PCNL_XuanCe/XuanPolicy_Library/xuanpolicy/xuanpolicy/mindspore/runners/runner_marl.py", "Python", 105, 0, 0, 3, 18, 126
"/home/wzliu/PCNL_XuanCe/XuanPolicy_Library/xuanpolicy/xuanpolicy/mindspore/utils/__init__.py", "Python", 2, 0, 0, 0, 0, 2
"/home/wzliu/PCNL_XuanCe/XuanPolicy_Library/xuanpolicy/xuanpolicy/mindspore/utils/distributions.py", "Python", 46, 0, 0, 0, 18, 64
"/home/wzliu/PCNL_XuanCe/XuanPolicy_Library/xuanpolicy/xuanpolicy/mindspore/utils/input_reformat.py", "Python", 83, 0, 0, 0, 11, 94
"/home/wzliu/PCNL_XuanCe/XuanPolicy_Library/xuanpolicy/xuanpolicy/mindspore/utils/layers.py", "Python", 90, 0, 0, 0, 12, 102
"/home/wzliu/PCNL_XuanCe/XuanPolicy_Library/xuanpolicy/xuanpolicy/mindspore/utils/operations.py", "Python", 47, 0, 0, 0, 12, 59
"/home/wzliu/PCNL_XuanCe/XuanPolicy_Library/xuanpolicy/xuanpolicy/mindspore/utils/set_trainer.py", "Python", 32, 0, 0, 0, 7, 39
"/home/wzliu/PCNL_XuanCe/XuanPolicy_Library/xuanpolicy/xuanpolicy/tensorflow/__init__.py", "Python", 0, 0, 0, 0, 1, 1
"/home/wzliu/PCNL_XuanCe/XuanPolicy_Library/xuanpolicy/xuanpolicy/tensorflow/agents/__init__.py", "Python", 109, 0, 0, 4, 9, 122
"/home/wzliu/PCNL_XuanCe/XuanPolicy_Library/xuanpolicy/xuanpolicy/tensorflow/agents/agent.py", "Python", 114, 0, 0, 6, 17, 137
"/home/wzliu/PCNL_XuanCe/XuanPolicy_Library/xuanpolicy/xuanpolicy/tensorflow/agents/agents_marl.py", "Python", 83, 0, 0, 2, 17, 102
"/home/wzliu/PCNL_XuanCe/XuanPolicy_Library/xuanpolicy/xuanpolicy/tensorflow/agents/multi_agent_rl/__init__.py", "Python", 0, 0, 0, 0, 1, 1
"/home/wzliu/PCNL_XuanCe/XuanPolicy_Library/xuanpolicy/xuanpolicy/tensorflow/agents/multi_agent_rl/coma_agents.py", "Python", 65, 0, 0, 2, 10, 77
"/home/wzliu/PCNL_XuanCe/XuanPolicy_Library/xuanpolicy/xuanpolicy/tensorflow/agents/multi_agent_rl/dcg_agents.py", "Python", 89, 0, 0, 2, 12, 103
"/home/wzliu/PCNL_XuanCe/XuanPolicy_Library/xuanpolicy/xuanpolicy/tensorflow/agents/multi_agent_rl/iddpg_agents.py", "Python", 82, 0, 0, 0, 11, 93
"/home/wzliu/PCNL_XuanCe/XuanPolicy_Library/xuanpolicy/xuanpolicy/tensorflow/agents/multi_agent_rl/iql_agents.py", "Python", 73, 0, 0, 2, 11, 86
"/home/wzliu/PCNL_XuanCe/XuanPolicy_Library/xuanpolicy/xuanpolicy/tensorflow/agents/multi_agent_rl/isac_agents.py", "Python", 81, 0, 0, 0, 11, 92
"/home/wzliu/PCNL_XuanCe/XuanPolicy_Library/xuanpolicy/xuanpolicy/tensorflow/agents/multi_agent_rl/maddpg_agents.py", "Python", 83, 0, 0, 0, 11, 94
"/home/wzliu/PCNL_XuanCe/XuanPolicy_Library/xuanpolicy/xuanpolicy/tensorflow/agents/multi_agent_rl/mappoclip_agents.py", "Python", 86, 0, 0, 0, 14, 100
"/home/wzliu/PCNL_XuanCe/XuanPolicy_Library/xuanpolicy/xuanpolicy/tensorflow/agents/multi_agent_rl/mappokl_agents.py", "Python", 85, 0, 0, 0, 14, 99
"/home/wzliu/PCNL_XuanCe/XuanPolicy_Library/xuanpolicy/xuanpolicy/tensorflow/agents/multi_agent_rl/masac_agents.py", "Python", 81, 0, 0, 0, 11, 92
"/home/wzliu/PCNL_XuanCe/XuanPolicy_Library/xuanpolicy/xuanpolicy/tensorflow/agents/multi_agent_rl/matd3_agents.py", "Python", 83, 0, 0, 0, 11, 94
"/home/wzliu/PCNL_XuanCe/XuanPolicy_Library/xuanpolicy/xuanpolicy/tensorflow/agents/multi_agent_rl/mfac_agents.py", "Python", 90, 0, 0, 0, 16, 106
"/home/wzliu/PCNL_XuanCe/XuanPolicy_Library/xuanpolicy/xuanpolicy/tensorflow/agents/multi_agent_rl/mfq_agents.py", "Python", 98, 0, 0, 0, 12, 110
"/home/wzliu/PCNL_XuanCe/XuanPolicy_Library/xuanpolicy/xuanpolicy/tensorflow/agents/multi_agent_rl/qmix_agents.py", "Python", 76, 0, 0, 2, 11, 89
"/home/wzliu/PCNL_XuanCe/XuanPolicy_Library/xuanpolicy/xuanpolicy/tensorflow/agents/multi_agent_rl/qtran_agents.py", "Python", 83, 0, 0, 2, 12, 97
"/home/wzliu/PCNL_XuanCe/XuanPolicy_Library/xuanpolicy/xuanpolicy/tensorflow/agents/multi_agent_rl/vdac_agents.py", "Python", 94, 0, 0, 0, 14, 108
"/home/wzliu/PCNL_XuanCe/XuanPolicy_Library/xuanpolicy/xuanpolicy/tensorflow/agents/multi_agent_rl/vdn_agents.py", "Python", 75, 0, 0, 2, 11, 88
"/home/wzliu/PCNL_XuanCe/XuanPolicy_Library/xuanpolicy/xuanpolicy/tensorflow/agents/multi_agent_rl/wqmix_agents.py", "Python", 78, 0, 0, 2, 11, 91
"/home/wzliu/PCNL_XuanCe/XuanPolicy_Library/xuanpolicy/xuanpolicy/tensorflow/agents/policy_gradient/__init__.py", "Python", 0, 0, 0, 0, 1, 1
"/home/wzliu/PCNL_XuanCe/XuanPolicy_Library/xuanpolicy/xuanpolicy/tensorflow/agents/policy_gradient/a2c_agent.py", "Python", 125, 0, 0, 1, 18, 144
"/home/wzliu/PCNL_XuanCe/XuanPolicy_Library/xuanpolicy/xuanpolicy/tensorflow/agents/policy_gradient/ddpg_agent.py", "Python", 111, 0, 0, 1, 18, 130
"/home/wzliu/PCNL_XuanCe/XuanPolicy_Library/xuanpolicy/xuanpolicy/tensorflow/agents/policy_gradient/mpdqn_agent.py", "Python", 161, 0, 0, 0, 19, 180
"/home/wzliu/PCNL_XuanCe/XuanPolicy_Library/xuanpolicy/xuanpolicy/tensorflow/agents/policy_gradient/pdqn_agent.py", "Python", 159, 0, 0, 0, 19, 178
"/home/wzliu/PCNL_XuanCe/XuanPolicy_Library/xuanpolicy/xuanpolicy/tensorflow/agents/policy_gradient/pg_agent.py", "Python", 125, 0, 0, 1, 19, 145
"/home/wzliu/PCNL_XuanCe/XuanPolicy_Library/xuanpolicy/xuanpolicy/tensorflow/agents/policy_gradient/ppg_agent.py", "Python", 128, 0, 0, 4, 19, 151
"/home/wzliu/PCNL_XuanCe/XuanPolicy_Library/xuanpolicy/xuanpolicy/tensorflow/agents/policy_gradient/ppoclip_agent.py", "Python", 127, 0, 0, 1, 18, 146
"/home/wzliu/PCNL_XuanCe/XuanPolicy_Library/xuanpolicy/xuanpolicy/tensorflow/agents/policy_gradient/ppokl_agent.py", "Python", 122, 0, 0, 1, 18, 141
"/home/wzliu/PCNL_XuanCe/XuanPolicy_Library/xuanpolicy/xuanpolicy/tensorflow/agents/policy_gradient/sac_agent.py", "Python", 108, 0, 0, 1, 19, 128
"/home/wzliu/PCNL_XuanCe/XuanPolicy_Library/xuanpolicy/xuanpolicy/tensorflow/agents/policy_gradient/sacdis_agent.py", "Python", 115, 0, 0, 2, 16, 133
"/home/wzliu/PCNL_XuanCe/XuanPolicy_Library/xuanpolicy/xuanpolicy/tensorflow/agents/policy_gradient/spdqn_agent.py", "Python", 165, 0, 0, 0, 19, 184
"/home/wzliu/PCNL_XuanCe/XuanPolicy_Library/xuanpolicy/xuanpolicy/tensorflow/agents/policy_gradient/td3_agent.py", "Python", 112, 0, 0, 1, 18, 131
"/home/wzliu/PCNL_XuanCe/XuanPolicy_Library/xuanpolicy/xuanpolicy/tensorflow/agents/qlearning_family/__init__.py", "Python", 0, 0, 0, 0, 1, 1
"/home/wzliu/PCNL_XuanCe/XuanPolicy_Library/xuanpolicy/xuanpolicy/tensorflow/agents/qlearning_family/c51_agent.py", "Python", 117, 0, 0, 2, 19, 138
"/home/wzliu/PCNL_XuanCe/XuanPolicy_Library/xuanpolicy/xuanpolicy/tensorflow/agents/qlearning_family/ddqn_agent.py", "Python", 117, 0, 0, 2, 19, 138
"/home/wzliu/PCNL_XuanCe/XuanPolicy_Library/xuanpolicy/xuanpolicy/tensorflow/agents/qlearning_family/dqn_agent.py", "Python", 117, 0, 0, 2, 18, 137
"/home/wzliu/PCNL_XuanCe/XuanPolicy_Library/xuanpolicy/xuanpolicy/tensorflow/agents/qlearning_family/drqn_agent.py", "Python", 131, 0, 0, 2, 18, 151
"/home/wzliu/PCNL_XuanCe/XuanPolicy_Library/xuanpolicy/xuanpolicy/tensorflow/agents/qlearning_family/dueldqn_agent.py", "Python", 117, 0, 0, 2, 19, 138
"/home/wzliu/PCNL_XuanCe/XuanPolicy_Library/xuanpolicy/xuanpolicy/tensorflow/agents/qlearning_family/noisydqn_agent.py", "Python", 116, 0, 0, 2, 19, 137
"/home/wzliu/PCNL_XuanCe/XuanPolicy_Library/xuanpolicy/xuanpolicy/tensorflow/agents/qlearning_family/perdqn_agent.py", "Python", 123, 0, 0, 2, 20, 145
"/home/wzliu/PCNL_XuanCe/XuanPolicy_Library/xuanpolicy/xuanpolicy/tensorflow/agents/qlearning_family/qrdqn_agent.py", "Python", 117, 0, 0, 2, 19, 138
"/home/wzliu/PCNL_XuanCe/XuanPolicy_Library/xuanpolicy/xuanpolicy/tensorflow/learners/__init__.py", "Python", 47, 0, 0, 0, 4, 51
"/home/wzliu/PCNL_XuanCe/XuanPolicy_Library/xuanpolicy/xuanpolicy/tensorflow/learners/learner.py", "Python", 66, 0, 0, 2, 12, 80
"/home/wzliu/PCNL_XuanCe/XuanPolicy_Library/xuanpolicy/xuanpolicy/tensorflow/learners/multi_agent_rl/__init__.py", "Python", 0, 0, 0, 0, 1, 1
"/home/wzliu/PCNL_XuanCe/XuanPolicy_Library/xuanpolicy/xuanpolicy/tensorflow/learners/multi_agent_rl/coma_learner.py", "Python", 115, 0, 0, 8, 17, 140
"/home/wzliu/PCNL_XuanCe/XuanPolicy_Library/xuanpolicy/xuanpolicy/tensorflow/learners/multi_agent_rl/dcg_learner.py", "Python", 155, 0, 0, 11, 20, 186
"/home/wzliu/PCNL_XuanCe/XuanPolicy_Library/xuanpolicy/xuanpolicy/tensorflow/learners/multi_agent_rl/iddpg_learner.py", "Python", 77, 0, 0, 7, 12, 96
"/home/wzliu/PCNL_XuanCe/XuanPolicy_Library/xuanpolicy/xuanpolicy/tensorflow/learners/multi_agent_rl/iql_learner.py", "Python", 58, 0, 0, 5, 12, 75
"/home/wzliu/PCNL_XuanCe/XuanPolicy_Library/xuanpolicy/xuanpolicy/tensorflow/learners/multi_agent_rl/isac_learner.py", "Python", 82, 0, 0, 5, 13, 100
"/home/wzliu/PCNL_XuanCe/XuanPolicy_Library/xuanpolicy/xuanpolicy/tensorflow/learners/multi_agent_rl/maddpg_learner.py", "Python", 77, 0, 0, 9, 12, 98
"/home/wzliu/PCNL_XuanCe/XuanPolicy_Library/xuanpolicy/xuanpolicy/tensorflow/learners/multi_agent_rl/mappoclip_learner.py", "Python", 77, 0, 0, 7, 12, 96
"/home/wzliu/PCNL_XuanCe/XuanPolicy_Library/xuanpolicy/xuanpolicy/tensorflow/learners/multi_agent_rl/mappokl_learner.py", "Python", 86, 0, 0, 7, 14, 107
"/home/wzliu/PCNL_XuanCe/XuanPolicy_Library/xuanpolicy/xuanpolicy/tensorflow/learners/multi_agent_rl/masac_learner.py", "Python", 82, 0, 0, 5, 13, 100
"/home/wzliu/PCNL_XuanCe/XuanPolicy_Library/xuanpolicy/xuanpolicy/tensorflow/learners/multi_agent_rl/matd3_learner.py", "Python", 83, 0, 0, 6, 11, 100
"/home/wzliu/PCNL_XuanCe/XuanPolicy_Library/xuanpolicy/xuanpolicy/tensorflow/learners/multi_agent_rl/mfac_learner.py", "Python", 91, 0, 0, 11, 14, 116
"/home/wzliu/PCNL_XuanCe/XuanPolicy_Library/xuanpolicy/xuanpolicy/tensorflow/learners/multi_agent_rl/mfq_learner.py", "Python", 73, 0, 0, 8, 13, 94
"/home/wzliu/PCNL_XuanCe/XuanPolicy_Library/xuanpolicy/xuanpolicy/tensorflow/learners/multi_agent_rl/qmix_learner.py", "Python", 61, 0, 0, 7, 11, 79
"/home/wzliu/PCNL_XuanCe/XuanPolicy_Library/xuanpolicy/xuanpolicy/tensorflow/learners/multi_agent_rl/qtran_learner.py", "Python", 92, 0, 0, 8, 12, 112
"/home/wzliu/PCNL_XuanCe/XuanPolicy_Library/xuanpolicy/xuanpolicy/tensorflow/learners/multi_agent_rl/vdac_learner.py", "Python", 64, 0, 0, 6, 12, 82
"/home/wzliu/PCNL_XuanCe/XuanPolicy_Library/xuanpolicy/xuanpolicy/tensorflow/learners/multi_agent_rl/vdn_learner.py", "Python", 59, 0, 0, 6, 12, 77
"/home/wzliu/PCNL_XuanCe/XuanPolicy_Library/xuanpolicy/xuanpolicy/tensorflow/learners/multi_agent_rl/wqmix_learner.py", "Python", 83, 0, 0, 11, 14, 108
"/home/wzliu/PCNL_XuanCe/XuanPolicy_Library/xuanpolicy/xuanpolicy/tensorflow/learners/policy_gradient/__init__.py", "Python", 0, 0, 0, 0, 1, 1
"/home/wzliu/PCNL_XuanCe/XuanPolicy_Library/xuanpolicy/xuanpolicy/tensorflow/learners/policy_gradient/a2c_learner.py", "Python", 43, 0, 0, 0, 9, 52
"/home/wzliu/PCNL_XuanCe/XuanPolicy_Library/xuanpolicy/xuanpolicy/tensorflow/learners/policy_gradient/ddpg_learner.py", "Python", 63, 0, 0, 2, 12, 77
"/home/wzliu/PCNL_XuanCe/XuanPolicy_Library/xuanpolicy/xuanpolicy/tensorflow/learners/policy_gradient/mpdqn_learner.py", "Python", 68, 0, 0, 2, 12, 82
"/home/wzliu/PCNL_XuanCe/XuanPolicy_Library/xuanpolicy/xuanpolicy/tensorflow/learners/policy_gradient/pdqn_learner.py", "Python", 68, 0, 0, 2, 12, 82
"/home/wzliu/PCNL_XuanCe/XuanPolicy_Library/xuanpolicy/xuanpolicy/tensorflow/learners/policy_gradient/pg_learner.py", "Python", 37, 0, 0, 0, 11, 48
"/home/wzliu/PCNL_XuanCe/XuanPolicy_Library/xuanpolicy/xuanpolicy/tensorflow/learners/policy_gradient/ppg_learner.py", "Python", 95, 0, 0, 1, 15, 111
"/home/wzliu/PCNL_XuanCe/XuanPolicy_Library/xuanpolicy/xuanpolicy/tensorflow/learners/policy_gradient/ppoclip_learner.py", "Python", 47, 0, 0, 1, 8, 56
"/home/wzliu/PCNL_XuanCe/XuanPolicy_Library/xuanpolicy/xuanpolicy/tensorflow/learners/policy_gradient/ppokl_learner.py", "Python", 56, 0, 0, 1, 9, 66
"/home/wzliu/PCNL_XuanCe/XuanPolicy_Library/xuanpolicy/xuanpolicy/tensorflow/learners/policy_gradient/sac_learner.py", "Python", 65, 0, 0, 3, 12, 80
"/home/wzliu/PCNL_XuanCe/XuanPolicy_Library/xuanpolicy/xuanpolicy/tensorflow/learners/policy_gradient/sacdis_learner.py", "Python", 69, 0, 0, 3, 12, 84
"/home/wzliu/PCNL_XuanCe/XuanPolicy_Library/xuanpolicy/xuanpolicy/tensorflow/learners/policy_gradient/spdqn_learner.py", "Python", 72, 0, 0, 2, 12, 86
"/home/wzliu/PCNL_XuanCe/XuanPolicy_Library/xuanpolicy/xuanpolicy/tensorflow/learners/policy_gradient/td3_learner.py", "Python", 63, 0, 0, 6, 11, 80
"/home/wzliu/PCNL_XuanCe/XuanPolicy_Library/xuanpolicy/xuanpolicy/tensorflow/learners/qlearning_family/__init__.py", "Python", 0, 0, 0, 0, 1, 1
"/home/wzliu/PCNL_XuanCe/XuanPolicy_Library/xuanpolicy/xuanpolicy/tensorflow/learners/qlearning_family/c51_learner.py", "Python", 41, 0, 0, 0, 13, 54
"/home/wzliu/PCNL_XuanCe/XuanPolicy_Library/xuanpolicy/xuanpolicy/tensorflow/learners/qlearning_family/cdqn_learner.py", "Python", 38, 0, 0, 1, 8, 47
"/home/wzliu/PCNL_XuanCe/XuanPolicy_Library/xuanpolicy/xuanpolicy/tensorflow/learners/qlearning_family/cldqn_learner.py", "Python", 40, 0, 0, 1, 8, 49
"/home/wzliu/PCNL_XuanCe/XuanPolicy_Library/xuanpolicy/xuanpolicy/tensorflow/learners/qlearning_family/ddqn_learner.py", "Python", 40, 0, 0, 1, 9, 50
"/home/wzliu/PCNL_XuanCe/XuanPolicy_Library/xuanpolicy/xuanpolicy/tensorflow/learners/qlearning_family/dqn_learner.py", "Python", 41, 0, 0, 0, 8, 49
"/home/wzliu/PCNL_XuanCe/XuanPolicy_Library/xuanpolicy/xuanpolicy/tensorflow/learners/qlearning_family/drqn_learner.py", "Python", 44, 0, 0, 2, 11, 57
"/home/wzliu/PCNL_XuanCe/XuanPolicy_Library/xuanpolicy/xuanpolicy/tensorflow/learners/qlearning_family/dueldqn_learner.py", "Python", 39, 0, 0, 1, 8, 48
"/home/wzliu/PCNL_XuanCe/XuanPolicy_Library/xuanpolicy/xuanpolicy/tensorflow/learners/qlearning_family/ldqn_learner.py", "Python", 39, 0, 0, 1, 8, 48
"/home/wzliu/PCNL_XuanCe/XuanPolicy_Library/xuanpolicy/xuanpolicy/tensorflow/learners/qlearning_family/perdqn_learner.py", "Python", 41, 0, 0, 1, 9, 51
"/home/wzliu/PCNL_XuanCe/XuanPolicy_Library/xuanpolicy/xuanpolicy/tensorflow/learners/qlearning_family/qrdqn_learner.py", "Python", 39, 0, 0, 1, 7, 47
"/home/wzliu/PCNL_XuanCe/XuanPolicy_Library/xuanpolicy/xuanpolicy/tensorflow/policies/__init__.py", "Python", 166, 0, 0, 3, 9, 178
"/home/wzliu/PCNL_XuanCe/XuanPolicy_Library/xuanpolicy/xuanpolicy/tensorflow/policies/categorical.py", "Python", 195, 0, 0, 3, 31, 229
"/home/wzliu/PCNL_XuanCe/XuanPolicy_Library/xuanpolicy/xuanpolicy/tensorflow/policies/categorical_marl.py", "Python", 253, 0, 0, 1, 30, 284
"/home/wzliu/PCNL_XuanCe/XuanPolicy_Library/xuanpolicy/xuanpolicy/tensorflow/policies/deterministic.py", "Python", 706, 0, 0, 0, 97, 803
"/home/wzliu/PCNL_XuanCe/XuanPolicy_Library/xuanpolicy/xuanpolicy/tensorflow/policies/deterministic_marl.py", "Python", 680, 0, 0, 26, 81, 787
"/home/wzliu/PCNL_XuanCe/XuanPolicy_Library/xuanpolicy/xuanpolicy/tensorflow/policies/gaussian.py", "Python", 215, 0, 0, 2, 32, 249
"/home/wzliu/PCNL_XuanCe/XuanPolicy_Library/xuanpolicy/xuanpolicy/tensorflow/policies/gaussian_marl.py", "Python", 215, 0, 0, 3, 29, 247
"/home/wzliu/PCNL_XuanCe/XuanPolicy_Library/xuanpolicy/xuanpolicy/tensorflow/policies/mixers.py", "Python", 204, 0, 0, 8, 32, 244
"/home/wzliu/PCNL_XuanCe/XuanPolicy_Library/xuanpolicy/xuanpolicy/tensorflow/representations/__init__.py", "Python", 40, 0, 0, 0, 5, 45
"/home/wzliu/PCNL_XuanCe/XuanPolicy_Library/xuanpolicy/xuanpolicy/tensorflow/representations/networks.py", "Python", 288, 0, 0, 1, 46, 335
"/home/wzliu/PCNL_XuanCe/XuanPolicy_Library/xuanpolicy/xuanpolicy/tensorflow/runners/__init__.py", "Python", 7, 0, 0, 0, 2, 9
"/home/wzliu/PCNL_XuanCe/XuanPolicy_Library/xuanpolicy/xuanpolicy/tensorflow/runners/runner_basic.py", "Python", 126, 0, 0, 3, 19, 148
"/home/wzliu/PCNL_XuanCe/XuanPolicy_Library/xuanpolicy/xuanpolicy/tensorflow/runners/runner_drl.py", "Python", 103, 0, 0, 9, 16, 128
"/home/wzliu/PCNL_XuanCe/XuanPolicy_Library/xuanpolicy/xuanpolicy/tensorflow/runners/runner_marl.py", "Python", 105, 0, 0, 3, 18, 126
"/home/wzliu/PCNL_XuanCe/XuanPolicy_Library/xuanpolicy/xuanpolicy/tensorflow/utils/__init__.py", "Python", 3, 0, 0, 0, 0, 3
"/home/wzliu/PCNL_XuanCe/XuanPolicy_Library/xuanpolicy/xuanpolicy/tensorflow/utils/distributions.py", "Python", 70, 0, 0, 0, 28, 98
"/home/wzliu/PCNL_XuanCe/XuanPolicy_Library/xuanpolicy/xuanpolicy/tensorflow/utils/input_reformat.py", "Python", 82, 0, 0, 0, 12, 94
"/home/wzliu/PCNL_XuanCe/XuanPolicy_Library/xuanpolicy/xuanpolicy/tensorflow/utils/layers.py", "Python", 107, 0, 0, 0, 13, 120
"/home/wzliu/PCNL_XuanCe/XuanPolicy_Library/xuanpolicy/xuanpolicy/tensorflow/utils/operations.py", "Python", 51, 0, 0, 3, 17, 71
"/home/wzliu/PCNL_XuanCe/XuanPolicy_Library/xuanpolicy/xuanpolicy/torch/__init__.py", "Python", 0, 0, 0, 0, 1, 1
"/home/wzliu/PCNL_XuanCe/XuanPolicy_Library/xuanpolicy/xuanpolicy/torch/agents/__init__.py", "Python", 104, 0, 0, 0, 6, 110
"/home/wzliu/PCNL_XuanCe/XuanPolicy_Library/xuanpolicy/xuanpolicy/torch/agents/agent.py", "Python", 115, 0, 0, 6, 17, 138
"/home/wzliu/PCNL_XuanCe/XuanPolicy_Library/xuanpolicy/xuanpolicy/torch/agents/agents_marl.py", "Python", 72, 0, 0, 3, 15, 90
"/home/wzliu/PCNL_XuanCe/XuanPolicy_Library/xuanpolicy/xuanpolicy/torch/agents/multi_agent_rl/__init__.py", "Python", 0, 0, 0, 0, 1, 1
"/home/wzliu/PCNL_XuanCe/XuanPolicy_Library/xuanpolicy/xuanpolicy/torch/agents/multi_agent_rl/coma_agents.py", "Python", 77, 0, 0, 4, 11, 92
"/home/wzliu/PCNL_XuanCe/XuanPolicy_Library/xuanpolicy/xuanpolicy/torch/agents/multi_agent_rl/dcg_agents.py", "Python", 99, 0, 0, 0, 11, 110
"/home/wzliu/PCNL_XuanCe/XuanPolicy_Library/xuanpolicy/xuanpolicy/torch/agents/multi_agent_rl/iddpg_agents.py", "Python", 58, 0, 0, 0, 6, 64
"/home/wzliu/PCNL_XuanCe/XuanPolicy_Library/xuanpolicy/xuanpolicy/torch/agents/multi_agent_rl/iql_agents.py", "Python", 81, 0, 0, 0, 11, 92
"/home/wzliu/PCNL_XuanCe/XuanPolicy_Library/xuanpolicy/xuanpolicy/torch/agents/multi_agent_rl/isac_agents.py", "Python", 57, 0, 0, 0, 7, 64
"/home/wzliu/PCNL_XuanCe/XuanPolicy_Library/xuanpolicy/xuanpolicy/torch/agents/multi_agent_rl/maddpg_agents.py", "Python", 57, 0, 0, 0, 7, 64
"/home/wzliu/PCNL_XuanCe/XuanPolicy_Library/xuanpolicy/xuanpolicy/torch/agents/multi_agent_rl/mappo_agents.py", "Python", 102, 0, 0, 4, 11, 117
"/home/wzliu/PCNL_XuanCe/XuanPolicy_Library/xuanpolicy/xuanpolicy/torch/agents/multi_agent_rl/masac_agents.py", "Python", 57, 0, 0, 0, 8, 65
"/home/wzliu/PCNL_XuanCe/XuanPolicy_Library/xuanpolicy/xuanpolicy/torch/agents/multi_agent_rl/matd3_agents.py", "Python", 61, 0, 0, 0, 7, 68
"/home/wzliu/PCNL_XuanCe/XuanPolicy_Library/xuanpolicy/xuanpolicy/torch/agents/multi_agent_rl/mfac_agents.py", "Python", 73, 0, 0, 0, 11, 84
"/home/wzliu/PCNL_XuanCe/XuanPolicy_Library/xuanpolicy/xuanpolicy/torch/agents/multi_agent_rl/mfq_agents.py", "Python", 77, 0, 0, 0, 10, 87
"/home/wzliu/PCNL_XuanCe/XuanPolicy_Library/xuanpolicy/xuanpolicy/torch/agents/multi_agent_rl/qmix_agents.py", "Python", 84, 0, 0, 0, 11, 95
"/home/wzliu/PCNL_XuanCe/XuanPolicy_Library/xuanpolicy/xuanpolicy/torch/agents/multi_agent_rl/qtran_agents.py", "Python", 58, 0, 0, 0, 9, 67
"/home/wzliu/PCNL_XuanCe/XuanPolicy_Library/xuanpolicy/xuanpolicy/torch/agents/multi_agent_rl/vdac_agents.py", "Python", 69, 0, 0, 0, 10, 79
"/home/wzliu/PCNL_XuanCe/XuanPolicy_Library/xuanpolicy/xuanpolicy/torch/agents/multi_agent_rl/vdn_agents.py", "Python", 83, 0, 0, 0, 11, 94
"/home/wzliu/PCNL_XuanCe/XuanPolicy_Library/xuanpolicy/xuanpolicy/torch/agents/multi_agent_rl/wqmix_agents.py", "Python", 86, 0, 0, 0, 11, 97
"/home/wzliu/PCNL_XuanCe/XuanPolicy_Library/xuanpolicy/xuanpolicy/torch/agents/policy_gradient/__init__.py", "Python", 0, 0, 0, 0, 1, 1
"/home/wzliu/PCNL_XuanCe/XuanPolicy_Library/xuanpolicy/xuanpolicy/torch/agents/policy_gradient/a2c_agent.py", "Python", 144, 0, 0, 1, 17, 162
"/home/wzliu/PCNL_XuanCe/XuanPolicy_Library/xuanpolicy/xuanpolicy/torch/agents/policy_gradient/ddpg_agent.py", "Python", 116, 0, 0, 1, 18, 135
"/home/wzliu/PCNL_XuanCe/XuanPolicy_Library/xuanpolicy/xuanpolicy/torch/agents/policy_gradient/mpdqn_agent.py", "Python", 159, 0, 0, 0, 19, 178
"/home/wzliu/PCNL_XuanCe/XuanPolicy_Library/xuanpolicy/xuanpolicy/torch/agents/policy_gradient/pdqn_agent.py", "Python", 158, 0, 0, 0, 20, 178
"/home/wzliu/PCNL_XuanCe/XuanPolicy_Library/xuanpolicy/xuanpolicy/torch/agents/policy_gradient/pg_agent.py", "Python", 134, 0, 0, 1, 15, 150
"/home/wzliu/PCNL_XuanCe/XuanPolicy_Library/xuanpolicy/xuanpolicy/torch/agents/policy_gradient/ppg_agent.py", "Python", 149, 0, 0, 4, 18, 171
"/home/wzliu/PCNL_XuanCe/XuanPolicy_Library/xuanpolicy/xuanpolicy/torch/agents/policy_gradient/ppoclip_agent.py", "Python", 148, 0, 0, 1, 19, 168
"/home/wzliu/PCNL_XuanCe/XuanPolicy_Library/xuanpolicy/xuanpolicy/torch/agents/policy_gradient/ppokl_agent.py", "Python", 146, 0, 0, 1, 18, 165
"/home/wzliu/PCNL_XuanCe/XuanPolicy_Library/xuanpolicy/xuanpolicy/torch/agents/policy_gradient/sac_agent.py", "Python", 112, 0, 0, 1, 19, 132
"/home/wzliu/PCNL_XuanCe/XuanPolicy_Library/xuanpolicy/xuanpolicy/torch/agents/policy_gradient/sacdis_agent.py", "Python", 119, 0, 0, 1, 16, 136
"/home/wzliu/PCNL_XuanCe/XuanPolicy_Library/xuanpolicy/xuanpolicy/torch/agents/policy_gradient/spdqn_agent.py", "Python", 157, 0, 0, 0, 19, 176
"/home/wzliu/PCNL_XuanCe/XuanPolicy_Library/xuanpolicy/xuanpolicy/torch/agents/policy_gradient/td3_agent.py", "Python", 116, 0, 0, 1, 18, 135
"/home/wzliu/PCNL_XuanCe/XuanPolicy_Library/xuanpolicy/xuanpolicy/torch/agents/qlearning_family/__init__.py", "Python", 0, 0, 0, 0, 1, 1
"/home/wzliu/PCNL_XuanCe/XuanPolicy_Library/xuanpolicy/xuanpolicy/torch/agents/qlearning_family/c51_agent.py", "Python", 121, 0, 0, 2, 19, 142
"/home/wzliu/PCNL_XuanCe/XuanPolicy_Library/xuanpolicy/xuanpolicy/torch/agents/qlearning_family/ddqn_agent.py", "Python", 122, 0, 0, 2, 18, 142
"/home/wzliu/PCNL_XuanCe/XuanPolicy_Library/xuanpolicy/xuanpolicy/torch/agents/qlearning_family/dqn_agent.py", "Python", 121, 0, 0, 2, 18, 141
"/home/wzliu/PCNL_XuanCe/XuanPolicy_Library/xuanpolicy/xuanpolicy/torch/agents/qlearning_family/drqn_agent.py", "Python", 138, 0, 0, 2, 20, 160
"/home/wzliu/PCNL_XuanCe/XuanPolicy_Library/xuanpolicy/xuanpolicy/torch/agents/qlearning_family/dueldqn_agent.py", "Python", 122, 0, 0, 2, 19, 143
"/home/wzliu/PCNL_XuanCe/XuanPolicy_Library/xuanpolicy/xuanpolicy/torch/agents/qlearning_family/noisydqn_agent.py", "Python", 122, 0, 0, 2, 19, 143
"/home/wzliu/PCNL_XuanCe/XuanPolicy_Library/xuanpolicy/xuanpolicy/torch/agents/qlearning_family/perdqn_agent.py", "Python", 128, 0, 0, 2, 20, 150
"/home/wzliu/PCNL_XuanCe/XuanPolicy_Library/xuanpolicy/xuanpolicy/torch/agents/qlearning_family/qrdqn_agent.py", "Python", 122, 0, 0, 2, 19, 143
"/home/wzliu/PCNL_XuanCe/XuanPolicy_Library/xuanpolicy/xuanpolicy/torch/learners/__init__.py", "Python", 43, 0, 0, 1, 4, 48
"/home/wzliu/PCNL_XuanCe/XuanPolicy_Library/xuanpolicy/xuanpolicy/torch/learners/learner.py", "Python", 79, 0, 0, 0, 17, 96
"/home/wzliu/PCNL_XuanCe/XuanPolicy_Library/xuanpolicy/xuanpolicy/torch/learners/multi_agent_rl/__init__.py", "Python", 0, 0, 0, 0, 1, 1
"/home/wzliu/PCNL_XuanCe/XuanPolicy_Library/xuanpolicy/xuanpolicy/torch/learners/multi_agent_rl/coma_learner.py", "Python", 98, 0, 0, 8, 16, 122
"/home/wzliu/PCNL_XuanCe/XuanPolicy_Library/xuanpolicy/xuanpolicy/torch/learners/multi_agent_rl/dcg_learner.py", "Python", 188, 0, 0, 8, 22, 218
"/home/wzliu/PCNL_XuanCe/XuanPolicy_Library/xuanpolicy/xuanpolicy/torch/learners/multi_agent_rl/iddpg_learner.py", "Python", 64, 0, 0, 5, 11, 80
"/home/wzliu/PCNL_XuanCe/XuanPolicy_Library/xuanpolicy/xuanpolicy/torch/learners/multi_agent_rl/iql_learner.py", "Python", 104, 0, 0, 9, 21, 134
"/home/wzliu/PCNL_XuanCe/XuanPolicy_Library/xuanpolicy/xuanpolicy/torch/learners/multi_agent_rl/isac_learner.py", "Python", 70, 0, 0, 6, 11, 87
"/home/wzliu/PCNL_XuanCe/XuanPolicy_Library/xuanpolicy/xuanpolicy/torch/learners/multi_agent_rl/maddpg_learner.py", "Python", 67, 0, 0, 9, 10, 86
"/home/wzliu/PCNL_XuanCe/XuanPolicy_Library/xuanpolicy/xuanpolicy/torch/learners/multi_agent_rl/mappo_learner.py", "Python", 178, 0, 0, 14, 20, 212
"/home/wzliu/PCNL_XuanCe/XuanPolicy_Library/xuanpolicy/xuanpolicy/torch/learners/multi_agent_rl/masac_learner.py", "Python", 70, 0, 0, 6, 11, 87
"/home/wzliu/PCNL_XuanCe/XuanPolicy_Library/xuanpolicy/xuanpolicy/torch/learners/multi_agent_rl/matd3_learner.py", "Python", 76, 0, 0, 6, 9, 91
"/home/wzliu/PCNL_XuanCe/XuanPolicy_Library/xuanpolicy/xuanpolicy/torch/learners/multi_agent_rl/mfac_learner.py", "Python", 80, 0, 0, 10, 13, 103
"/home/wzliu/PCNL_XuanCe/XuanPolicy_Library/xuanpolicy/xuanpolicy/torch/learners/multi_agent_rl/mfq_learner.py", "Python", 57, 0, 0, 7, 11, 75
"/home/wzliu/PCNL_XuanCe/XuanPolicy_Library/xuanpolicy/xuanpolicy/torch/learners/multi_agent_rl/qmix_learner.py", "Python", 111, 0, 0, 11, 18, 140
"/home/wzliu/PCNL_XuanCe/XuanPolicy_Library/xuanpolicy/xuanpolicy/torch/learners/multi_agent_rl/qtran_learner.py", "Python", 84, 0, 0, 8, 11, 103
"/home/wzliu/PCNL_XuanCe/XuanPolicy_Library/xuanpolicy/xuanpolicy/torch/learners/multi_agent_rl/vdac_learner.py", "Python", 50, 0, 0, 6, 10, 66
"/home/wzliu/PCNL_XuanCe/XuanPolicy_Library/xuanpolicy/xuanpolicy/torch/learners/multi_agent_rl/vdn_learner.py", "Python", 108, 0, 0, 14, 18, 140
"/home/wzliu/PCNL_XuanCe/XuanPolicy_Library/xuanpolicy/xuanpolicy/torch/learners/multi_agent_rl/wqmix_learner.py", "Python", 168, 0, 0, 19, 23, 210
"/home/wzliu/PCNL_XuanCe/XuanPolicy_Library/xuanpolicy/xuanpolicy/torch/learners/policy_gradient/__init__.py", "Python", 0, 0, 0, 0, 1, 1
"/home/wzliu/PCNL_XuanCe/XuanPolicy_Library/xuanpolicy/xuanpolicy/torch/learners/policy_gradient/a2c_learner.py", "Python", 41, 0, 0, 1, 9, 51
"/home/wzliu/PCNL_XuanCe/XuanPolicy_Library/xuanpolicy/xuanpolicy/torch/learners/policy_gradient/ddpg_learner.py", "Python", 44, 0, 0, 3, 10, 57
"/home/wzliu/PCNL_XuanCe/XuanPolicy_Library/xuanpolicy/xuanpolicy/torch/learners/policy_gradient/mpdqn_learner.py", "Python", 46, 0, 0, 2, 12, 60
"/home/wzliu/PCNL_XuanCe/XuanPolicy_Library/xuanpolicy/xuanpolicy/torch/learners/policy_gradient/pdqn_learner.py", "Python", 46, 0, 0, 2, 19, 67
"/home/wzliu/PCNL_XuanCe/XuanPolicy_Library/xuanpolicy/xuanpolicy/torch/learners/policy_gradient/pg_learner.py", "Python", 35, 0, 0, 1, 9, 45
"/home/wzliu/PCNL_XuanCe/XuanPolicy_Library/xuanpolicy/xuanpolicy/torch/learners/policy_gradient/ppg_learner.py", "Python", 78, 0, 0, 2, 11, 91
"/home/wzliu/PCNL_XuanCe/XuanPolicy_Library/xuanpolicy/xuanpolicy/torch/learners/policy_gradient/ppoclip_learner.py", "Python", 54, 0, 0, 2, 10, 66
"/home/wzliu/PCNL_XuanCe/XuanPolicy_Library/xuanpolicy/xuanpolicy/torch/learners/policy_gradient/ppokl_learner.py", "Python", 52, 0, 0, 2, 9, 63
"/home/wzliu/PCNL_XuanCe/XuanPolicy_Library/xuanpolicy/xuanpolicy/torch/learners/policy_gradient/sac_learner.py", "Python", 44, 0, 0, 3, 10, 57
"/home/wzliu/PCNL_XuanCe/XuanPolicy_Library/xuanpolicy/xuanpolicy/torch/learners/policy_gradient/sacdis_learner.py", "Python", 50, 0, 0, 5, 10, 65
"/home/wzliu/PCNL_XuanCe/XuanPolicy_Library/xuanpolicy/xuanpolicy/torch/learners/policy_gradient/spdqn_learner.py", "Python", 46, 0, 0, 2, 12, 60
"/home/wzliu/PCNL_XuanCe/XuanPolicy_Library/xuanpolicy/xuanpolicy/torch/learners/policy_gradient/td3_learner.py", "Python", 49, 0, 0, 6, 9, 64
"/home/wzliu/PCNL_XuanCe/XuanPolicy_Library/xuanpolicy/xuanpolicy/torch/learners/qlearning_family/__init__.py", "Python", 0, 0, 0, 0, 1, 1
"/home/wzliu/PCNL_XuanCe/XuanPolicy_Library/xuanpolicy/xuanpolicy/torch/learners/qlearning_family/c51_learner.py", "Python", 41, 0, 0, 1, 9, 51
"/home/wzliu/PCNL_XuanCe/XuanPolicy_Library/xuanpolicy/xuanpolicy/torch/learners/qlearning_family/ddqn_learner.py", "Python", 39, 0, 0, 1, 11, 51
"/home/wzliu/PCNL_XuanCe/XuanPolicy_Library/xuanpolicy/xuanpolicy/torch/learners/qlearning_family/dqn_learner.py", "Python", 38, 0, 0, 1, 9, 48
"/home/wzliu/PCNL_XuanCe/XuanPolicy_Library/xuanpolicy/xuanpolicy/torch/learners/qlearning_family/drqn_learner.py", "Python", 42, 0, 0, 2, 11, 55
"/home/wzliu/PCNL_XuanCe/XuanPolicy_Library/xuanpolicy/xuanpolicy/torch/learners/qlearning_family/dueldqn_learner.py", "Python", 38, 0, 0, 1, 9, 48
"/home/wzliu/PCNL_XuanCe/XuanPolicy_Library/xuanpolicy/xuanpolicy/torch/learners/qlearning_family/perdqn_learner.py", "Python", 39, 0, 0, 1, 9, 49
"/home/wzliu/PCNL_XuanCe/XuanPolicy_Library/xuanpolicy/xuanpolicy/torch/learners/qlearning_family/qrdqn_learner.py", "Python", 37, 0, 0, 1, 8, 46
"/home/wzliu/PCNL_XuanCe/XuanPolicy_Library/xuanpolicy/xuanpolicy/torch/learners/ssl_rl/__init__.py", "Python", 0, 0, 0, 0, 1, 1
"/home/wzliu/PCNL_XuanCe/XuanPolicy_Library/xuanpolicy/xuanpolicy/torch/learners/ssl_rl/curl_learner.py", "Python", 0, 0, 0, 0, 1, 1
"/home/wzliu/PCNL_XuanCe/XuanPolicy_Library/xuanpolicy/xuanpolicy/torch/policies/__init__.py", "Python", 159, 0, 0, 3, 8, 170
"/home/wzliu/PCNL_XuanCe/XuanPolicy_Library/xuanpolicy/xuanpolicy/torch/policies/categorical.py", "Python", 208, 0, 0, 7, 34, 249
"/home/wzliu/PCNL_XuanCe/XuanPolicy_Library/xuanpolicy/xuanpolicy/torch/policies/categorical_marl.py", "Python", 222, 0, 0, 6, 28, 256
"/home/wzliu/PCNL_XuanCe/XuanPolicy_Library/xuanpolicy/xuanpolicy/torch/policies/coordination_graph.py", "Python", 68, 0, 0, 1, 9, 78
"/home/wzliu/PCNL_XuanCe/XuanPolicy_Library/xuanpolicy/xuanpolicy/torch/policies/deterministic.py", "Python", 743, 0, 0, 2, 97, 842
"/home/wzliu/PCNL_XuanCe/XuanPolicy_Library/xuanpolicy/xuanpolicy/torch/policies/deterministic_marl.py", "Python", 504, 0, 0, 4, 64, 572
"/home/wzliu/PCNL_XuanCe/XuanPolicy_Library/xuanpolicy/xuanpolicy/torch/policies/gaussian.py", "Python", 217, 0, 0, 2, 31, 250
"/home/wzliu/PCNL_XuanCe/XuanPolicy_Library/xuanpolicy/xuanpolicy/torch/policies/gaussian_marl.py", "Python", 188, 0, 0, 4, 31, 223
"/home/wzliu/PCNL_XuanCe/XuanPolicy_Library/xuanpolicy/xuanpolicy/torch/policies/mixers.py", "Python", 117, 0, 0, 6, 19, 142
"/home/wzliu/PCNL_XuanCe/XuanPolicy_Library/xuanpolicy/xuanpolicy/torch/representations/__init__.py", "Python", 38, 0, 0, 0, 6, 44
"/home/wzliu/PCNL_XuanCe/XuanPolicy_Library/xuanpolicy/xuanpolicy/torch/representations/cnn.py", "Python", 83, 0, 0, 1, 10, 94
"/home/wzliu/PCNL_XuanCe/XuanPolicy_Library/xuanpolicy/xuanpolicy/torch/representations/mlp.py", "Python", 42, 0, 0, 2, 8, 52
"/home/wzliu/PCNL_XuanCe/XuanPolicy_Library/xuanpolicy/xuanpolicy/torch/representations/rnn.py", "Python", 71, 0, 0, 0, 8, 79
"/home/wzliu/PCNL_XuanCe/XuanPolicy_Library/xuanpolicy/xuanpolicy/torch/runners/__init__.py", "Python", 13, 0, 0, 0, 2, 15
"/home/wzliu/PCNL_XuanCe/XuanPolicy_Library/xuanpolicy/xuanpolicy/torch/runners/runner_basic.py", "Python", 11, 0, 0, 2, 6, 19
"/home/wzliu/PCNL_XuanCe/XuanPolicy_Library/xuanpolicy/xuanpolicy/torch/runners/runner_drl.py", "Python", 119, 0, 0, 3, 14, 136
"/home/wzliu/PCNL_XuanCe/XuanPolicy_Library/xuanpolicy/xuanpolicy/torch/runners/runner_football.py", "Python", 102, 0, 0, 5, 18, 125
"/home/wzliu/PCNL_XuanCe/XuanPolicy_Library/xuanpolicy/xuanpolicy/torch/runners/runner_magent.py", "Python", 5, 0, 0, 0, 3, 8
"/home/wzliu/PCNL_XuanCe/XuanPolicy_Library/xuanpolicy/xuanpolicy/torch/runners/runner_pettingzoo.py", "Python", 339, 0, 0, 11, 43, 393
"/home/wzliu/PCNL_XuanCe/XuanPolicy_Library/xuanpolicy/xuanpolicy/torch/runners/runner_sc2.py", "Python", 319, 0, 0, 13, 39, 371
"/home/wzliu/PCNL_XuanCe/XuanPolicy_Library/xuanpolicy/xuanpolicy/torch/utils/__init__.py", "Python", 22, 0, 0, 0, 4, 26
"/home/wzliu/PCNL_XuanCe/XuanPolicy_Library/xuanpolicy/xuanpolicy/torch/utils/distributions.py", "Python", 72, 0, 0, 0, 29, 101
"/home/wzliu/PCNL_XuanCe/XuanPolicy_Library/xuanpolicy/xuanpolicy/torch/utils/input_reformat.py", "Python", 104, 0, 0, 0, 15, 119
"/home/wzliu/PCNL_XuanCe/XuanPolicy_Library/xuanpolicy/xuanpolicy/torch/utils/layers.py", "Python", 101, 0, 0, 0, 12, 113
"/home/wzliu/PCNL_XuanCe/XuanPolicy_Library/xuanpolicy/xuanpolicy/torch/utils/operations.py", "Python", 86, 0, 0, 0, 18, 104
"/home/wzliu/PCNL_XuanCe/XuanPolicy_Library/xuanpolicy/xuanpolicy/torch/utils/value_norm.py", "Python", 54, 0, 0, 3, 20, 77
"Total", "-", 36964, 13, 6419, 2416, 6986, 52798